Rp, Rp, Uu, Uu, Xu, Xu, Xu, Xu, Xu, Xu, Xu, Xu, Xu, Xu, Xu, Xu, Xu, Xu, Xu, Xu, Wog, Wog, Wog, Xu, Xu, Xu, Xu, Xu, Xu, Xu, Xu, Xu, Xu, Xu, Xu, Xu, Xu, Xu, Xu, Xuc, Xuc, Xuc, Xuc, Xuc, Xuc, Xuc, Xuc, Xuc, Xuc, Xuc, Xuc, Xuc
Uu, Rp, Rp, Uu, Uu^Uf, Xu, Xu, Xu, Xu, Xu, Xu, Xu, Xu, Xu, Xu, Xu, Xu, Xu, Xu, Xu, Wog, Wog, Wog, Xu, Xu, Xu, Xu, Xu, Xu, Xu, Xu, Xu, Xu, Xu, Xu, Xu, Xu, Xu, Xu, Xuc, Xuc, Xuc, Xuc, Xuc, Xu, Xuc, Xuc, Xuc, Xuc, Xuc, Xuc, Xuc
Uu, Uu^Uf, Uu^Ufi, Uu^Ii, Uu^Ufi, Rp, Rp, Xu, Xu, Xu, Xu, Xu, Xu, Xu, Xu, Xu, Wog, Wog, Wog, Wog, Wog, Wog, Wwg, Wwg, Wwf, Uu^Uf, Uu, Xu, Uu, Xu, Qxu, Qxu, Qxu, Qxu, Qxu, Xu, Xu, Xu, Xu, Xuc, Xu, Xu, Xu, Xu, Xu, Xu, Xu, Xuc, Xu, Xuc, Xuc, Xuc
Xu, Uu, Uu, Rp^Ii, Rp, Uu, Uu, Xu, Xu, Xu, Xu, Xu, Xu, Xu, Xu, Xu, Wog, Wog, Wog, Wog, Wog, Wog, Wwg, Wwf, Ur, Uu, Uh, Ur, Ur, Ur, Uu^Uf, Qxu, Qxu, Qxu, Qxu, Qxu, Qxu, Xu, Xu, Xu, Xos, Xos, Wog, Wog, Wog, Xu, Wog, Xos, Xos, Xu, Xu, Xuc
Xu, Xu, Xu, Uu, Rp, Rp, Ce, Uu^Uf, Uh, Xu, Xu, Xu, Xu, Xu, Xu, Wog, Wog, Wog, Wwg, Wwg, Wwg, Wwg, Xu, Wwf, Uh, Ur, Uu, Ur, Uu, Uu^Uf, Ur, Uu, Ur, Ur, Uu^Ufi, Qxu, Qxu, Xu, Xu, Xos, Wog, Wog, Wwg, Wog, Chw, Wog, Wwg, Wog, Wog, Xos, Xu, Xuc
Xu, Xu, Xu, Xu, Uh, Ce, 1 Ke, Ce, Rp, Xu, Xu, Xu, Wwg, Xu, Wog, Wog, Wog, Wwg, Xu, Xu, Xu, Xu, Xu, Xu, Xu, Uh, Qxu, Uu, Qxu, Ur, Ur, Uu^Uf, Ur, Uu^Uf, Uu^Uf, Qxu, Xu, Xu, Xos, Xos, Wog, Wwg, Rp, Chw, 4 Khw, Chw, Rp, Wwg, Qxu, Xos, Xu, Xu
Xu, Xu, Xu, Xu, Uh, Ce, Ce, Ce, Rp, Uh^Ii, Uu^Ii, Wwf, Wwg, Wwg, Wog, Wog, Wog, Wwg, Xu, Xu, Xu, Xu, Xu, Xu, Xu, Qxu, Qxu, Qxu, Qxu, Qxu, Uu, Uu, Cte, Cte, Cte, Uu, Xu, Xu, Xos, Wog, Wwg, Wwg, Wwg, Chw, Chw, Chw, Rp, Wwg, Wwg, Qxu, Xu, Xu
Xu, Xu, Xu, Xu, Xu, Uh, Uu, Rp, Rp, Wwf^Bw\r, Wwf^Bw\r, Wwf, Wwg, Wog, Wog, Wog, Wwg, Wwg, Xu, Xu, Xu, Xu, Xu, Xu, Xu, Xu, Uu, Qxu, Qxu^Bcx/, Qxu^Bcx/, Qxu, Uh, Cte, 5 Kte, Cte, Xu, Xu, Xos, Rp, Wog, Rp, Rp, Wog, Wog, Wog, Wwg, Wwg, Wwg, Wog, Wog, Xu, Xu
Xu, Xu, Xu, Xu, Xu, Uu^Uf, Uu^Uf, Uu, Wwf, Wwf^Bw\r, Wwf^Bw\r, Wwg^Bw\r, Wwf^Bw\r, Wwg, Wwg, Wwg, Uu^Uf, Rp, Rp, Xu, Uu^Vu, Xu, Uu, Uu^Uf, Uu^Uf, Ur, Uu, Qxu^Bcx/, Qxu, Qxu, Qxu, Uh, Xu, Cte, Xu, Xu, Xu, Xos, Rp, Wwg, Xu, Xu, Xu, Xu, Xu, Wwg, Rp, Wwg, Wog, Wog, Xu, Xu
Xu, Xu, Xu, Xu, Xu, Uu, Wwf, Wwf, Wwg, Wwg, Wwf, Wwg^Bw\r, Wwf^Bw\r, Rp, Uu, Uh, Uu, Uu^Uf, Rp, Rp, Rp, Uh, Uh, Uu^Uf, Rp, Ur, Xu, Uh, Xu, Xu, Xu, Xu, Xu, Xu, Xu, Xu, Xu, Wwg, Wwg, Wwg, Xu, Xu, Xu, Xu, Xu, Wwg, Wwg, Rp, Qxu, Qxu, Xu, Xu
Xu, Xu, Xu, Xu, Wwg, Wwf, Wwg, Wwf, Wwg, Wwf, Wwg, Wwg, Uu^Vu, Rp, Uu, Uh, Uh, Uu, Rp, Uu, Rp, Uh, Uh, Rp, Uu, Uu^Vu, Xu, Xu, Xu, Xu, Xu, Xu, Xuc, Xu, Xu, Xu, Xu, Wog, Rp, Xu, Xu, Xu, Xu, Xu, Wog, Wog, Wwg, Rp, Qxu, Qxu, Xu, Xu
Xu, Xu, Xu, Xu, Wog, Wog, Wog, Wwg, Wwf, Wwf, Uu, Ur, Rp, Rp, Rp, Uu^Uf, Uu, Rp, Uu^Uf, Uu, Rp, Uu^Uf, Rp, Rp, Uu, Uh, Uh, Xu, Xu, Xuc, Xu, Xu, Xu, Xu, Xu, Xu, Wwg, Wog, Rp, Xu, Xu, Xu, Xu, Xu, Wwg, Wwg, Rp, Qxu, Qxu, Xu, Xu, Xu
Xu, Xu, Xu, Wog, Wog, Wog, Wog, Wwg, Wwg, Uu, Uh, Rp, Ur, Ur, Rp, Uu^Uf, Uu^Vu, Rp, Cer, Cer, Cer, Rp, Rp, Uu, Rp, Rp, Uh, Xu, Xu, Xu, Xos, Xos, Xos, Xos, Xu, Xu, Uu, Wwg, Xu, Xu, Xu, Xu, Xu, Xu, Wog, Rp, Qxu, Qxu, Qxu, Xu, Xu, Xu
Xu, Xu, Wog, Wog, Wog, Wog, Xu, Wwg, Uu^Vu, Uh, Uu, Uh, Uu^Uf, Uu^Vu, Rp, Rp, Rp, Rp, Cer, 6 Ker, Cer, Ur, Uu, Rp, Uu^Uf, Uu, Xu, Xu, Xu, Xos, Uu, Rp, Ur, Cvr, Uu, Rp, Rp, Uu^Ufi, Uu^Uf, Xu, Xu, Xu, Xu, Wog, Wwg, Rp, Qxu, Qxu, Qxu, Xos, Xu, Xu
Wog, Wog, Wog, Wog, Wog, Xu, Xu, Rp, Rp, Rp, Rp, Uu^Uf, Rp, Rp, Ur, Uu, Uu^Uf, Uh, Uh, Cer, Rp, Ur, Uu, Uu^Uf, Uu, Uu, Xos, Xu, Xos, Xos, Uu, Uu^Vu, Ur, Rp, Uh, Uh, Xu, Uu, Rp, Uu, Xu, Xu, Uu, Ur, Ur, Xu, Xu, Qxu, Qxu, Xos, Xu, Xu
Wog, Wog, Wog, Wog, Xu, Xu, Xu, Xu, Uu, Uu, Uu, Rp, Uu, Ur, Rp, Uu, Uu, Uu^Uf, Uh, Uh, Rp, Uu^Vu, Ur, Uu^Uf, Cvr, Xos, Xos, Xos, Qxu, Cvr, 7 Kvr, Ur, Rp, Uu, Cvr, Xu, Xu, Xu, Rp, Rp, Ur, Xu, Rp, Uu^Ufi, Xu, Xu, Qxu, Qxu, Qxu, Xos, Xu, Xu
Wog, Wog, Xu, Wog, Xu, Xu, Xu, Xu, Xu, Uh, Uh, Uh, Uu, Uu^Uf, Ur, Rp, Rp, Rp, Rp, Rp, Ur, Ur, Cvr, Cvr, Uu^Xo, Xos, Xol, Xol, Qxu, Cvr, Cvr, Cvr, Uu, Rp, Xu, Xu, Xu, Xu, Xu, Uu^Uf, Uu, Cvr, Cvr, Uu, Qxu, Xu, Qxu, Qxu, Xos, Xos, Xu, Xu
Xu, Xu, Xu, Xu, Xu, Xu, Xu, Xu, Xu, Xu, Xu, Xu, Xu, Uu^Uf, Xu, Uu^Vu, Uh, Uu^Uf, Xu, Ur, Xos, Cvr, Uu^Xo, Uu^Xo, Cvr, Cvr, Qxu, Qxu, Qxu, Qxu, Qxu, Qxu, Qxu, Xu, Xu, Xu, Xu, Xu, Xu, Uu, Uh, Xu, Xu, Xu, Xu, Qxu, Qxu, Qxu, Xu, Xu, Xu, Xu
Xu, Xu, Xu, Xu, Xu, Xu, Xu, Xu, Xu, Xu, Xu, Xu, Xu, Xu, Xu, Xu, Xu, Xu, Xu, Xu, Xu, Xos, Cvr, Cvr, Rp, Ur, Qxu, Qxu, Qxu, Qxu, Qxu, Qxu, Qxu, Xu, Xu, Xu, Uu^Uf, Xu, Rp, Uu, Uh, Xu, Xu, Xu, Xu, Xu, Qxu, Qxu, Xu, Xu, Xu, Xu
Xu, Xu, Xu, Xu, Qxu, Xu, Qxu, Uu^Vu, Rp, Rb, Cvr, Xu, Xu, Xu, Xu, Xu, Xu, Xu, Xu, Xu, Xos, Xos, Qxu, Rp, Ur, Uu, Rp, Qxu, Qxu, Qxu, Qxu, Qxu, Rp, Uu, Uu, Uu, Ur, Uh, Uu, Rp, Xos, Xu, Xu, Xu, Xu, Xu, Qxu, Qxu, Xu, Xu, Xu, Xu
Xu, Xu, Xu, Qxu, Qxu, Qxu, Qxu, Qxu, Cvr, Rb, Rb, Xu, Xu, Xu, Xu, Xu, Xu, Xu, Xos, Xos, Xol, Xol, Qxu, Qxu, Qxu, Uu, Rp, Ur, Qxu, Qxu, Xu, Xu, Rp, Rp, Uh, Uh, Cvr, Uu, Uh, Rp, Xos, Xu, Uu^Vu, Xu, Xu, Xu, Uh, Qxu, Xu, Xu, Xu, Xu
Xu, Xu, Xu, Qxu, Qxu, Qxu, Qxu, Cvr, 3 Kvr, Cvr, Rp, Rp, Xos, Xu, Xu, Xu, Xos, Xos, Qxu, Qxu, Qxu, Qxu, Qxu, Qxu, Qxu, Ur, Rp, Rp, Uu, Qxu, Xu, Xu, Xu, Cvr, Rp, Rp, Ur, Uu, Uu^Uf, Xos, Xos, Uh, Uh, Rp, Uu, Uh, Uu^Uf, Xu, Xu, Xu, Xu, Xu
Xu, Xu, Xu, Qxu, Qxu, Qxu, Ur, Cvr, Cvr, Cvr, Uu, Uu, Rp, Xos, Xos, Xu, Uh, Qxu, Qxu, Qxu, Qxu, Qxu, Qxu, Qxu, Uh, Uh, Uu^Uf, Uu, Rp, Rp, Uh, Xu, Xu, Xu, Uu^Ufi, Uu^Uf, Ur, Uh, Uh, Xos, Xos, Xos, Xu, Rp, Uu, Uu, Xu, Xu, Xu, Xu, Xu, Xu
Xu, Xu, Xu, Xu, Qxu, Qxu, Qxu, Uu, Uu, Rp, Rp, Rp, Cvr, Uu, Xos, Xos, Uh, Uu^Vu, Uu, Rp, Rp, Qxu, Qxu, Qxu, Rp, Uu, Rb, Uu, Rp, Uu^Uf, Uh, Xu, Xu, Uu, Uu, Uu, Xu, Cvr, Uu, Uu, Xos, Xos, Xu, Xu, Uu^Ufi, Rp, Xos, Xu, Xu, Xu, Xu, Xu
Xu, Xu, Xu, Xu, Qxu, Qxu, Qxu, Uu^Vu, Rp, Uu, Rp, Rb, Ur, Rb, Uu^Uf, Xos, Ur, Uu^Uf, Uu^Ufi, Rb, Rb, Uu, Uu^Ufi, Uu, Uu, Rp, Uu^Uf, Uu^Vu, Uu, Uu, Rp, Uu^Ufi, Ur, Ur, Ur, Rp, Xu, Xu, Uu, Uh, Rp, Xu, Uh, Xu, Rp, Rp, Xos, Xu, Xu, Xu, Xu, Xu
Xu, Xu, Xu, Xu, Xu, Qxu, Qxu, Qxu, Xu, Cvr, Xu, Uu, Uu^Vu, Uu, Urb, Rp, Uu^Uf, Urb, Uu, Xu, Xos, Uu, Urb, Uu, Xos, Uh, Uh, Uu^Ufi, Rb, Ur, Uh, Rp, Uu, Uh, Uh, Rp, Xu, Xu, Xu, Rp, Uu^Uf, Rp, Uu, Uh, Uu, Uu, Xos, Xu, Xu, Xu, Xu, Xu
Xu, Xu, Xu, Xu, Xu, Xu, Xu, Xu, Xuc, Xu, Xu, Xu, Xu, Xu, Xu, Rp, Rb, Uu^Uf, Xu, Xos, Xos, Urb, Uu, Xos, Xu, Xu, Uh, Rp, Rb, Uu, Uu, Rp, Sm, Uu^Uf, Sm, Xu, Xu, Xu, Xu, Xu, Xu, Uu^Uf, Xu, Ur, Cvr, Cvr, Cvr, Xos, Xu, Xu, Xu, Xu
Xu, Xu, Xu, Xu, Xos, Xos, Gll^Fmw, Xu, Xu, Xu, Xos, Xu, Xos, Xos, Xos, Uu, Rb, Rb, Rp, Xu, Rb, Ur, Uu, Xos, Xu, Xu, Ur, Rp, Rp, Uu^Uf, Uu^Uf, Sm, Sm, Sm, Sm, Sm, Xu, Xu, Xu, Xu, Xu, Xu, Xu, Ur, Cvr, 8 Kvr, Cvr, Xos, Xu, Xu, Xu, Xu
Xu, Xu, Xu, Xos, Qxu, Gll^Fmw, Gd^Fetd, Gll^Fdw, Qxu, Qxu, Qxu, Xos, Qxu, Xos, Xos, Xos, Xu, Uu, Uu, Rp, Rb, Uu, Xos, Xos, Xu, Qxu, Ur, Uu, Sm, Sm, Sm, Sm, Sm, Gll^Fdw, Gll^Fmw, Gll^Fmw, Sm, Xu, Gll^Fdw, Xu, Xu, Xu, Uu^Uf, Uu^Uf, Rp, Cvr, Xu, Xu, Xu, Xu, Xu, Xu
Xu, Xu, Xos, Xos, Qxu, Gll^Fdw, Gll^Fdw, Gll^Fmw, Gll^Fdw, Qxu, Gll^Fmw, Qxu, Qxu, Qxu, Uu, Uu, Rp, Xu, Xu, Rp, Qxu, Qxu, Qxu, Xu, Qxu, Qxu, Uh, Uh, Sm, Sm, Gll^Fdw, Sm, Sm, Sm, Sm, Sm, Sm, Sm, Gll^Fmw, Gll^Fdw, Xu, Xu, Uh, Uu^Vu, Rp, Xu, Xu, Xu, Xu, Xu, Xu, Xu
Xu, Xu, Xos, Qxu, Qxu, Qxu, Gll^Fdw, Hhd^Fmw, Hhd^Fdw, Gll^Fdw, Gll^Fmw, Gll^Fdw, Qxu, Qxu, Rp, Rp, Rp, Rp, Xos, Xos, Xos, Qxu, Qxu, Qxu, Qxu, Sm, Sm, Sm, Sm, Sm, Gll^Fmw, Gll^Fmw, Sm, Sm, Gll^Fmw, Gll^Fdw, Sm, Sm, Sm, Sm, Xu, Xu, Xu, Uh, Rp, Xu, Xu, Xu, Xu, Xu, Xu, Xu
Xuc, Xu, Qxu, Qxu, Qxu, Gll^Fdw, Gll^Fmw, Hhd^Fdw, Gll^Fdw, Gll^Fmw, Hhd^Fmw, Hhd, Rp, Rp, Rp, Rp, Qxu, Uu, Qxu, Xos, Xos, Qxu, Qxu, Qxu, Uu^Uf, Gll^Fdw, Gll^Fmw, Sm, Gll^Fdw, Sm, Sm, Sm, Gll^Fmw, Sm, Sm, Sm, Sm, Gll^Fmw, Rb, Xu, Xu, Xu, Xu, Uu, Uu, Xu, Xu, Xu, Xu, Xu, Xu, Xu
Xu, Xu, Qxu, Qxu, Qxu, Gll^Fmw, Cvr, Gll^Fmw, Hhd, Gll^Fmw, Rp, Rp, Rp, Rp, Hhd, Qxu, Qxu, Qxu, Qxu, Xos, Xu, Xos, Qxu, Qxu, Uu, Uu, Uu, Sm, Gll^Fdw, Gll^Fmw, Sm, Sm, Sm, Gll^Fdw, Sm, Sm, Ur, Ur, Rb, Xu, Xu, Xu, Cvr, Rb, Uu, Xu, Xu, Xu, Xu, Xu, Xu, Xu
Xu, Qxu, Qxu, Qxu, Ur, Ur, Gll^Fmw, Ur, Ur, Hhd, Hhd, Rp, Gll^Fmw, Hhd, Gll^Fmw, Gll^Fdw, Qxu, Qxu, Gll^Fdw, Xu, Xu, Xos, Qxu, Qxu, Qxu, Uu^Ufi, Uu^Uf, Sm, Sm, Sm, Gll^Fdw, Sm, Sm, Sm, Sm, Sm, Ur, Uu^Uf, Uu^Uf, Rb, Uh, Xu, Rb, Rb, Uu^Uf, Cvr, Xos, Xu, Xos, Xu, Xu, Xu
Xu, Qxu, Qxu, Cvr, Gll^Fmw, Gll^Fdw, Gll^Fmw, Gll^Fmw, Gll^Fmw, Cvr, Hhd, Gll^Fmw, Gll^Fmw, Gll^Fdw, Gll^Fmw, Gll^Fdw, Gll^Fdw, Gll^Fmw, Gll^Fmw, Xu, Xu, Xos, Xos, Qxu, Qxu, Qxu, Uh, Gll^Fmw, Sm, Sm, Gll^Fmw, Gll^Fmw, Gll^Fdw, Sm, Uu, Uu, Xu, Xu, Xu, Uu, Gll^Fdw, Gll^Fdw, Gll^Fdw, Gll^Fdw, Gll^Fdw, Uu, Gll^Fmw, Xos, Qxu, Xos, Xu, Xu
Xu, Qxu, Qxu, Ur, Gll^Fdw, Gll^Fdw, 2 Gll^Ii, Gll^Fdw, Gll^Fdw, Ur, Gll^Fdw, Gll^Fdw, Gll^Fmw, Gll^Fdw, Hhd^Fdw, Hhd^Fmw, Gll^Fdw, Gll^Fdw, Gll^Fdw, Gll^Fmw, Xu, Xu, Xos, Qxu, Qxu, Qxu, Qxu, Uh, Qxu, Sm, Qxu, Sm, Sm, Sm, Uh, Xu, Xos, Xos, Gll^Fdw, Gll^Fdw, Gll^Fmw, Gll^Fdw, Gll^Fmw, Gll^Fmw, Gll^Fmw, Gll^Fdw, Gll^Fmw, Gll^Fmw, Gll^Fmw, Qxu, Xu, Xu
Xu, Qxu, Qxu, Ur, Gll^Fmw, Gll^Fmw, Gll^Fdw, Gll^Fmw, Gll^Fdw, Ur, Gll^Fdw, Hhd^Fmw, Hhd^Fmw, Hhd^Fdw, Gll^Fmw, Hhd^Fdw, Gll^Fmw, Gll^Fmw, Gd^Fetd, Gll^Fmw, Xu, Xu, Xu, Qxu, Qxu, Qxu, Qxu, Qxu, Qxu, Qxu, Qxu, Qxu, Xu, Uh, Xu, Xu, Xos, Gll^Fmw, Gll^Fdw, Gll^Fdw, Gd^Fetd, Gll^Fmw, Gll^Fmw, Gll^Fmw, Gll^Fdw, Gll^Fmw, Gll^Fdw, Gll^Fmw, Gll^Fmw, Qxu, Xos, Xu
Xu, Xu, Qxu, Cvr, Ur, Gll^Fdw, Gll^Fmw, Gll^Fmw, Ur, Cvr, Qxu, Gll^Fdw, Qxu, Gll^Fdw, Qxu, Hhd^Fmw, Gll^Fdw, Gll^Fmw, Gll^Fmw, Gll^Fdw, Xu, Xu, Xu, Qxu, Qxu, Qxu, Xos, Qxu, Xos, Xos, Xos, Xos, Xu, Xu, Xu, Xu, Qxu, Gll^Fmw, Gll^Fmw, Gll^Fmw, Gll^Fdw, Gll^Fdw, Gll^Fmw, Gll^Fmw, Gll^Fdw, Gll^Fdw, Gd^Fetd, Gll^Fmw, Qxu, Qxu, Xos, Xu
Xu, Xu, Qxu, Qxu, Qxu, Ur, Cvr, Ur, Qxu, Qxu, Qxu, Qxu, Qxu, Qxu, Qxu, Qxu, Xos, Xos, Xos, Xos, Xu, Xu, Xu, Xu, Xu, Xos, Xu, Xos, Xu, Xu, Xu, Xu, Xu, Xu, Xu, Xos, Qxu, Qxu, Gll^Fdw, Gll^Fdw, Gll^Fdw, Gll^Fdw, Gll^Fdw, Gll^Fmw, Gll^Fdw, Gll^Fmw, Gll^Fmw, Gll^Fmw, Qxu, Qxu, Xos, Xu
Xu, Xu, Xu, Qxu, Qxu, Qxu, Qxu, Qxu, Xos, Xos, Xos, Qxu, Qxu, Qxu, Qxu, Qxu, Xu, Xu, Xu, Xu, Xu, Xu, Xu, Xu, Xu, Xu, Xu, Xu, Xu, Xu, Xu, Xu, Xu, Xu, Xu, Xos, Xos, Qxu, Gll^Fmw, Gll^Fmw, Gll^Fdw, Gll^Fmw, Gll^Fmw, Gll^Fmw, Gll^Fmw, Gll^Fdw, Gll^Fdw, Gll^Fdw, Qxu, Xos, Xu, Xu
Xu, Xu, Xu, Xu, Xu, Xu, Xu, Xos, Xu, Xu, Xu, Xos, Xos, Xos, Xu, Xu, Xu, Xu, Xu, Xu, Xu, Xu, Xu, Xu, Xu, Xu, Xu, Xu, Xu, Xu, Xu, Xu, Xu, Xu, Xu, Xu, Xu, Gll^Fmw, Gll^Fmw, Gll^Fdw, Qxu, Gll^Fdw, Xos, Gll^Fmw, Xos, Xos, Xos, Qxu, Qxu, Qxu, Xu, Xu
Xu, Xu, Xu, Xu, Xu, Xu, Xu, Xu, Xu, Xu, Xu, Xu, Xu, Xu, Xu, Xu, Xu, Xu, Xu, Xu, Xu, Xu, Xu, Xu, Xu, Xu, Xu, Xu, Xu, Xu, Xu, Xu, Xu, Xu, Xu, Xu, Xu, Xu, Xu, Qxu, Xu, Xos, Xu, Xos, Xu, Xu, Xu, Xos, Xu, Xu, Xu, Xu
Xu, Xu, Xu, Xu, Xu, Xu, Xu, Xu, Xu, Xu, Xu, Xu, Xu, Xu, Xu, Xu, Xu, Xu, Xu, Xu, Xu, Xu, Xu, Xu, Xu, Xu, Xu, Xu, Xu, Xu, Xu, Xu, Xu, Xu, Xu, Xu, Xu, Xu, Xu, Xu, Xu, Xu, Xu, Xu, Xu, Xu, Xu, Xu, Xu, Xu, Xu, Xu
