Rp, Rp, Uu, Uu, Xu, Xu, Xu, Xu, Xu, Xu, Xu, Xu, Xu, Xu, Xu, Xu, Xu, Xu, Xu, Xu, Wog, Wog, Wog, Xu, Xu, Xu, Xu, Xu, Xu, Xu, Xu, Xu, Xu, Xu, Xu, Xu, Xu, Xu, Xu, Xuc, Xuc, Xuc, Xuc, Xuc, Xuc, Xuc, Xuc, Xuc, Xuc, Xuc, Xuc, Xuc
Uu, Rp, Rp, Uu, Tb^Tf, Xu, Xu, Xu, Xu, Xu, Xu, Xu, Xu, Xu, Xu, Xu, Xu, Xu, Xu, Xu, Wog, Wog, Wog, Xu, Xu, Xu, Xu, Xu, Xu, Xu, Xu, Xu, Xu, Xu, Xu, Xu, Xu, Xu, Xu, Xuc, Xuc, Xuc, Xuc, Xuc, Xu, Xuc, Xuc, Xuc, Xuc, Xuc, Xuc, Xuc
Uu, Tb^Tf, Tb^Tf, Uu^Ii, Tb^Tf, Rp, Rp, Xu, Xu, Xu, Xu, Xu, Xu, Xu, Xu, Xu, Wog, Wog, Wog, Wog, Wog, Wog, Wwg, Wwg, Wwf, Tb^Tf, Uu, Xu, Uu, Xu, Qxu, Qxu, Qxu, Qxu, Qxu, Xu, Xu, Xu, Xu, Xuc, Xu, Xu, Xu, Xu, Xu, Xu, Xu, Xuc, Xu, Xuc, Xuc, Xuc
Xu, Uu, Uu, Rp^Ii, Rp, Uu, Uu, Xu, Xu, Xu, Xu, Xu, Xu, Xu, Xu, Xu, Wog, Wog, Wog, Wog, Wog, Wog, Wwg, Wwf, Ur, Uu, Uh, Ur, Ur, Ur, Tb^Tfi, Qxu, Qxu, Qxu, Qxu, Qxu, Qxu, Xu, Xu, Xu, Xoi, Xoi, Wog, Wog, Wog, Xu, Wog, Xoi, Xoi, Xu, Xu, Xuc
Xu, Xu, Xu, Uu, Rp, Rp, Ce, Tb^Tf, Uh, Xu, Xu, Xu, Xu, Xu, Xu, Wog, Wog, Wog, Wwg, Wwg, Wwg, Wwg, Xu, Wwf, Uh, Ur, Uu, Ur, Uu, Tb^Tfi, Ur, Uu, Ur, Ur, Tb^Tfi, Qxu, Qxu, Xu, Xu, Xoi, Wog, Wog, Wwg, Wog, Chw, Wog, Wwg, Wog, Wog, Xoi, Xu, Xuc
Xu, Xu, Xu, Xu, Uh, Ce, 1 Ke, Ce, Rp, Xu, Xu, Xu, Wwg, Xu, Wog, Wog, Wog, Wwg, Xu, Xu, Xu, Xu, Xu, Xu, Xu, Uh, Qxu, Ur, Qxu, Ur, Ur, Tb^Tfi, Ur, Tb^Tf, Tb^Tfi, Qxu, Xu, Xu, Xoi, Xoi, Wog, Wwg, Rp, Chw, 4 Khw, Chw, Rp, Wwg, Qxu, Xoi, Xu, Xu
Xu, Xu, Xu, Xu, Uh, Ce, Ce, Ce, Rp, Uh^Ii, Uu^Ii, Wwf, Wwg, Wwg, Wog, Wog, Wog, Wwg, Xu, Xu, Xu, Xu, Xu, Xu, Xu, Qxu, Qxu, Qxu, Qxu, Qxu, Ur, Uu, Cte, Cte, Cte, Ur, Xu, Xu, Xoi, Wog, Wwg, Wwf, Wwf, Chw, Chw, Chw, Rp, Wwg, Wwg, Qxu, Xu, Xu
Xu, Xu, Xu, Xu, Xu, Uh, Uu, Rp, Rp, Wwf^Bw\r, Wwf^Bw\r, Wwf, Wwg, Wog, Wog, Wog, Wwg, Wwg, Xu, Xu, Xu, Xu, Xu, Xu, Xu, Xu, Ur, Qxu, Qxu^Bcx/, Qxu^Bcx/, Qxu, Uh, Cte, 5 Kte, Cte, Xu, Xu, Xoi, Rp, Wog, Rp, Rp, Wog, Wog, Wog, Wwf, Wwf, Wwg, Wog, Wog, Xu, Xu
Xu, Xu, Xu, Xu, Xu, Tb^Tf, Tb^Tf, Uu, Wwf, Wwf^Bw\r, Wwf^Bw\r, Wwg^Bw\r, Wwf^Bw\r, Wwg, Wwg, Wwg, Tb^Tfi, Rp, Rp, Xu, Uu^Vu, Xu, Ur, Tb^Tfi, Tb^Tf, Ur, Uu, Qxu^Bcx/, Qxu, Qxu, Qxu, Uh, Xu, Cte, Xu, Xu, Xu, Xoi, Rp, Wwf, Xu, Xu, Xu, Xu, Xu, Wwf, Rp, Wwg, Wog, Wog, Xu, Xu
Xu, Xu, Xu, Xu, Xu, Uu, Wwf, Wwf, Wwg, Wwg, Wwf, Wwg^Bw\r, Wwf^Bw\r, Rp, Ur, Uh, Uu, Tb^Tfi, Rp, Rp, Rp, Uh, Uh, Tb^Tfi, Rp, Ur, Xu, Uh, Xu, Xu, Xu, Xu, Xu, Xu, Xu, Xu, Xu, Wwg, Wwf, Wwf, Xu, Xu, Xu, Xu, Xu, Wwg, Wwg, Rp, Qxu, Qxu, Xu, Xu
Xu, Xu, Xu, Xu, Wwg, Wwf, Wwg, Wwf, Wwg, Wwf, Wwg, Wwg, Uu^Vu, Rp, Ur, Uh, Uh, Uu, Rp, Ur, Rp, Uh, Uh, Rp, Ur, Uu^Vu, Xu, Xu, Xu, Xu, Xu, Xu, Xuc, Xu, Xu, Xu, Xu, Wog, Rp, Xu, Xu, Xu, Xu, Xu, Wog, Wog, Wwf, Rp, Qxu, Qxu, Xu, Xu
Xu, Xu, Xu, Xu, Wog, Wog, Wog, Wwg, Wwf, Wwf, Uu, Ur, Rp, Rp, Rp, Tb^Tfi, Ur, Rp, Tb^Tfi, Uu, Rp, Tb^Tfi, Rp, Rp, Uu, Uh, Uh, Xu, Xu, Xuc, Xu, Xu, Xu, Xu, Xu, Xu, Wwg, Wog, Rp, Xu, Xu, Xu, Xu, Xu, Wwg, Wwf, Rp, Qxu, Qxu, Xu, Xu, Xu
Xu, Xu, Xu, Wog, Wog, Wog, Wog, Wwg, Wwg, Uu, Uh, Rp, Ur, Ur, Rp, Tb^Tfi, Uu^Vu, Rp, Cer, Cer, Cer, Rp, Rp, Uu, Rp, Rp, Uh, Xu, Xu, Xu, Xoi, Xoi, Xoi, Xoi, Xu, Xu, Uu, Wwf, Xu, Xu, Xu, Xu, Xu, Xu, Wog, Rp, Qxu, Qxu, Qxu, Xu, Xu, Xu
Xu, Xu, Wog, Wog, Wog, Wog, Xu, Wwg, Uu^Vu, Uh, Ur, Uh, Tb^Tfi, Uu^Vu, Rp, Rp, Rp, Rp, Cer, 6 Ker, Cer, Ur, Ur, Rp, Tb^Tfi, Ur, Xu, Xu, Xu, Xoi, Uu, Rp, Ur, Cvr, Uu, Rp, Rp, Tb^Tfi, Tb^Tfi, Xu, Xu, Xu, Xu, Wog, Wwf, Rp, Qxu, Qxu, Qxu, Xoi, Xu, Xu
Wog, Wog, Wog, Wog, Wog, Xu, Xu, Rp, Rp, Rp, Rp, Tb^Tf, Rp, Rp, Ur, Uu, Tb^Tfi, Uh, Uh, Cer, Rp, Ur, Uu, Tb^Tfi, Uu, Uu, Xoi, Xu, Xoi, Xoi, Uu, Uu^Vu, Ur, Rp, Uh, Uh, Xu, Uu, Rp, Uu, Xu, Xu, Uu, Ur, Ur, Xu, Xu, Qxu, Qxu, Xoi, Xu, Xu
Wog, Wog, Wog, Wog, Xu, Xu, Xu, Xu, Uu, Uu, Uu, Rp, Ur, Ur, Rp, Uu, Ur, Tb^Tfi, Uh, Uh, Rp, Uu^Vu, Ur, Tb^Tf, Cvr, Xoi, Xoi, Xoi, Qxu, Cvr, 7 Kvr, Ur, Rp, Uu, Cvr, Xu, Xu, Xu, Rp, Rp, Ur, Xu, Rp, Tb^Tf, Xu, Xu, Qxu, Qxu, Qxu, Xoi, Xu, Xu
Wog, Wog, Xu, Wog, Xu, Xu, Xu, Xu, Xu, Uh, Uh, Uh, Ur, Tb^Tfi, Ur, Rp, Rp, Rp, Rp, Rp, Ur, Ur, Cvr, Cvr, Uu^Xo, Xoi, Xoi, Xoi, Qxu, Cvr, Cvr, Cvr, Uu, Rp, Xu, Xu, Xu, Xu, Xu, Tb^Tfi, Uu, Cvr, Cvr, Uu, Qxu, Xu, Qxu, Qxu, Xoi, Xoi, Xu, Xu
Xu, Xu, Xu, Xu, Xu, Xu, Xu, Xu, Xu, Xu, Xu, Xu, Xu, Tb^Tf, Xu, Uu^Vu, Uh, Tb^Tf, Xu, Ur, Xos, Cvr, Uu^Xo, Uu^Xo, Cvr, Cvr, Qxu, Qxu, Qxu^Bcx/, Qxu^Bcx/, Qxu^Bcx/, Qxu^Bcx/, Qxu, Xu, Xu, Xu, Xu, Xu, Xu, Ur, Uh, Xu, Xu, Xu, Xu, Qxu, Qxu, Qxu, Xu, Xu, Xu, Xu
Xu, Xu, Xu, Xu, Xu, Xu, Xu, Xu, Xu, Xu, Xu, Xu, Xu, Xu, Xu, Xu, Xu, Xu, Xu, Xu, Xu, Xos, Cvr, Cvr, Rp, Ur, Qxu^Bcx/, Qxu^Bcx/, Qxu^Bcx/, Qxu^Bcx/, Qxu, Qxu, Qxu, Xu, Xu, Xu, Tb^Tfi, Xu, Rp, Uu, Uh, Xu, Xu, Xu, Xu, Xu, Qxu, Qxu, Xu, Xu, Xu, Xu
Xu, Xu, Xu, Xu, Qxu, Xu, Qxu, Uu^Vu, Rp, Rb, Cvr, Xu, Xu, Xu, Xu, Xu, Xu, Xu, Xu, Xu, Xos, Xos, Qxu, Rp, Ur, Uu, Rp, Qxu^Bcx/, Qxu, Qxu, Qxu, Qxu, Rp, Uu, Uu, Uu, Ur, Uh, Ur, Rp, Xoi, Xu, Xu, Xu, Xu, Xu, Qxu, Qxu, Xu, Xu, Xu, Xu
Xu, Xu, Xu, Qxu, Qxu, Qxu, Qxu, Qxu, Cvr, Rb, Rb, Xu, Xu, Xu, Xu, Xu, Xu, Xu, Xoi, Xoi, Xoi, Xoi, Qxu, Qxu, Qxu, Ur, Rp, Ur, Qxu, Qxu, Xu, Xu, Rp, Rp, Uh, Uh, Cvr, Uu, Uh, Rp, Xoi, Xu, Uu^Vu, Xu, Xu, Xu, Uh, Qxu, Xu, Xu, Xu, Xu
Xu, Xu, Xu, Qxu, Qxu, Qxu, Qxu, Cvr, 3 Kvr, Cvr, Rp, Rp, Xoi, Xu, Xu, Xu, Xoi, Xoi, Qxu, Qxu, Qxu, Qxu, Qxu, Qxu, Qxu, Ur, Rp, Rp, Ur, Qxu, Xu, Xu, Xu, Cvr, Rp, Rp, Ur, Uu, Tb^Tfi, Xoi, Xoi, Uh, Uh, Rp, Ur, Uh, Tb^Tfi, Xu, Xu, Xu, Xu, Xu
Xu, Xu, Xu, Qxu, Qxu, Qxu, Ur, Cvr, Cvr, Cvr, Uu, Uu, Rp, Xoi, Xoi, Xu, Uh, Qxu, Qxu, Qxu, Qxu, Qxu, Qxu, Qxu, Uh, Uh, Tb^Tfi, Uu, Rp, Rp, Uh, Xu, Xu, Xu, Tb^Tfi, Tb^Tfi, Ur, Uh, Ur, Xoi, Xoi, Xoi, Xu, Rp, Uu, Uu, Xu, Xu, Xu, Xu, Xu, Xu
Xu, Xu, Xu, Xu, Qxu, Qxu, Qxu, Uu, Uu, Rp, Rp, Rp, Cvr, Uu, Xoi, Xoi, Uh, Uu^Vu, Uu, Rp, Rp, Qxu, Qxu, Qxu, Rp, Uu, Rb, Ur, Rp, Tb^Tf, Uh, Xu, Xu, Uu, Uu, Ur, Xu, Cvr, Ur, Uu, Xoi, Xoi, Xu, Xu, Tb^Tfi, Rp, Xoi, Xu, Xu, Xu, Xu, Xu
Xu, Xu, Xu, Xu, Qxu, Qxu, Qxu, Uu^Vu, Rp, Ur, Rp, Rb, Ur, Rb, Tb^Tfi, Xoi, Ur, Tb^Tf, Tb^Tfi, Rb, Rb, Uu, Tb^Tfi, Ur, Uu, Rp, Tb^Tf, Uu^Vu, Ur, Uu, Rp, Tb^Tfi, Ur, Ur, Ur, Rp, Xu, Xu, Uu, Uh, Rp, Xu, Uh, Xu, Rp, Rp, Xoi, Xu, Xu, Xu, Xu, Xu
Xu, Xu, Xu, Xu, Xu, Qxu, Qxu, Qxu, Xu, Cvr, Xu, Uu, Uu^Vu, Ur, Urb, Rp, Tb^Tfi, Urb, Uu, Xu, Xoi, Ur, Urb, Uu, Xoi, Uh, Uh, Tb^Tf, Rb, Ur, Uh, Rp, Uu, Uh, Uh, Rp, Xu, Xu, Xu, Rp, Tb^Tfi, Rp, Uu, Uh, Uu, Ur, Xoi, Xu, Xu, Xu, Xu, Xu
Xu, Xu, Xu, Xu, Xu, Xu, Xu, Xu, Xuc, Xu, Xu, Xu, Xu, Xu, Xu, Rp, Rb, Tb^Tf, Xu, Xoi, Xoi, Urb, Uu, Xoi, Xu, Xu, Uh, Rp, Rb, Uu, Ur, Rp, Sm, Tb^Tf, Sm, Xu, Xu, Xu, Xu, Xu, Xu, Tb^Tf, Xu, Ur, Rp, Rp, Xoi, Xos, Xu, Xu, Xu, Xu
Xu, Xu, Xu, Xu, Xoi, Xoi, Gll^Fmw, Xu, Xu, Xu, Xoi, Xu, Xoi, Xoi, Xoi, Uu, Rb, Rb, Rp, Xu, Rb, Ur, Uu, Xoi, Xu, Xu, Ur, Rp, Rp, Tb^Tf, Tb^Tf, Sm, Sm, Sm, Sm, Sm, Xu, Xu, Xu, Xu, Xu, Xu, Xu, Ur, Uu, Xoi, Xoi, Xoc, Xu, Xu, Xu, Xu
Xu, Xu, Xu, Xoi, Qxu, Gll^Fmw, Gd^Fetd, Gll^Fdw, Qxu, Qxu, Qxu, Xoi, Qxu, Xoi, Xoi, Xoi, Xu, Uu, Uu, Rp, Rb, Uu, Xoi, Xoi, Xu, Qxu, Ur, Uu, Sm, Sm, Sm, Sm, Sm, Gll^Fdw, Gll^Fmw, Gll^Fmw, Sm, Xu, Gll^Fdw, Xu, Xu, Xu, Tb^Tf, Tb^Tfi, Rp, Xoi, Xoi, Xu, Xu, Xu, Xu, Xu
Xu, Xu, Xoi, Xoi, Qxu, Gll^Fdw, Gll^Fdw, Gll^Fmw, Gll^Fdw, Qxu, Gll^Fmw, Qxu, Qxu, Qxu, Uu, Uu, Rp, Xu, Xu, Rp, Qxu, Qxu, Qxu, Xu, Qxu, Qxu, Uh, Uh, Sm, Sm, Gll^Fdw, Sm, Sm, Sm, Sm, Sm, Sm, Sm, Gll^Fmw, Gll^Fdw, Xu, Xu, Uh, Uu^Vu, Rp, Xu, Xu, Xu, Xu, Xu, Xu, Xu
Xu, Xu, Xoi, Qxu, Qxu, Qxu, Gll^Fdw, Hhd^Fmw, Hhd^Fdw, Gll^Fdw, Gll^Fmw, Gll^Fdw, Qxu, Qxu, Rp, Rp, Rp, Rp, Xoi, Xoi, Xoi, Qxu, Qxu, Qxu, Qxu, Sm, Sm, Sm, Sm, Sm, Gll^Fmw, Gll^Fmw, Sm, Sm, Gll^Fmw, Gll^Fdw, Sm, Sm, Sm, Sm, Xu, Xu, Xu, Uh, Rp, Xu, Xu, Xu, Xu, Xu, Xu, Xu
Xuc, Xu, Qxu, Qxu, Qxu, Gll^Fdw, Gll^Fmw, Hhd^Fdw, Gll^Fdw, Gll^Fmw, Hhd^Fmw, Hhd, Rp, Rp, Rp, Rp, Qxu, Uu, Qxu, Xoi, Xoi, Qxu, Qxu, Qxu, Tb^Tfi, Gll^Fdw, Gll^Fmw, Sm, Gll^Fdw, Sm, Sm, Sm, Gll^Fmw, Sm, Sm, Sm, Sm, Gll^Fmw, Rb, Xu, Xu, Xu, Xu, Ur, Ur, Xu, Xu, Xu, Xu, Xu, Xu, Xu
Xu, Xu, Qxu, Qxu, Qxu, Gll^Fmw, Cvr, Gll^Fmw, Hhd, Gll^Fmw, Rp, Rp, Rp, Rp, Hhd, Qxu, Qxu, Qxu, Qxu, Xoi, Xu, Xoi, Qxu, Qxu, Ur, Ur, Uu, Sm, Gll^Fdw, Gll^Fmw, Sm, Sm, Sm, Gll^Fdw, Sm, Sm, Ur, Ur, Rb, Xu, Xu, Xu, Cvr, Rb, Uu, Xu, Xu, Xu, Xu, Xu, Xu, Xu
Xu, Qxu, Qxu, Qxu, Ur, Ur, Gll^Fmw, Ur, Ur, Hhd, Hhd, Rp, Gll^Fmw, Hhd, Gll^Fmw, Gll^Fdw, Qxu, Qxu, Gll^Fdw, Xu, Xu, Xoi, Qxu, Qxu, Qxu, Tb^Tf, Tb^Tfi, Sm, Sm, Sm, Gll^Fdw, Sm, Sm, Sm, Sm, Sm, Ur, Tb^Tf, Tb^Tfi, Rb, Uh, Xu, Rb, Rb, Tb^Tfi, Cvr, Xoi, Xu, Xoi, Xu, Xu, Xu
Xu, Qxu, Qxu, Cvr, Gll^Fmw, Gll^Fdw, Gll^Fmw, Gll^Fmw, Gll^Fmw, Cvr, Hhd, Gll^Fmw, Gll^Fmw, Gll^Fdw, Gll^Fmw, Gll^Fdw, Gll^Fdw, Gll^Fmw, Gll^Fmw, Xu, Xu, Xoi, Xoi, Qxu, Qxu, Qxu, Uh, Gll^Fmw, Sm, Sm, Gll^Fmw, Gll^Fmw, Gll^Fdw, Sm, Uu, Uu, Xu, Xu, Xu, Uu, Gll^Fdw, Gll^Fdw, Gll^Fdw, Gll^Fdw, Gll^Fdw, Uu, Gll^Fmw, Xoi, Qxu, Xoi, Xu, Xu
Xu, Qxu, Qxu, Ur, Gll^Fdw, Gll^Fdw, 2 Gll^Ii, Gll^Fdw, Gll^Fdw, Ur, Gll^Fdw, Gll^Fdw, Gll^Fmw, Gll^Fdw, Hhd^Fdw, Hhd^Fmw, Gll^Fdw, Gll^Fdw, Gll^Fdw, Gll^Fmw, Xu, Xu, Xoi, Qxu, Qxu, Qxu, Qxu, Uh, Qxu, Sm, Qxu, Sm, Sm, Sm, Uh, Xu, Xoi, Xoi, Gll^Fdw, Gll^Fdw, Gll^Fmw, Gll^Fdw, Gll^Fmw, Gll^Fmw, Gll^Fmw, Gll^Fdw, Gll^Fmw, Gll^Fmw, Gll^Fmw, Qxu, Xu, Xu
Xu, Qxu, Qxu, Ur, Gll^Fmw, Gll^Fmw, Gll^Fdw, Gll^Fmw, Gll^Fdw, Ur, Gll^Fdw, Hhd^Fmw, Hhd^Fmw, Hhd^Fdw, Gll^Fmw, Hhd^Fdw, Gll^Fmw, Gll^Fmw, Gd^Fetd, Gll^Fmw, Xu, Xu, Xu, Qxu, Qxu, Qxu, Qxu, Qxu, Qxu, Qxu, Qxu, Qxu, Xu, Uh, Xu, Xu, Xoi, Gll^Fmw, Gll^Fdw, Gll^Fdw, Gd^Fetd, Gll^Fmw, Gll^Fmw, Gll^Fmw, Gll^Fdw, Gll^Fmw, Gll^Fdw, Gll^Fmw, Gll^Fmw, Qxu, Xoi, Xu
Xu, Xu, Qxu, Cvr, Ur, Gll^Fdw, Gll^Fmw, Gll^Fmw, Ur, Cvr, Qxu, Gll^Fdw, Qxu, Gll^Fdw, Qxu, Hhd^Fmw, Gll^Fdw, Gll^Fmw, Gll^Fmw, Gll^Fdw, Xu, Xu, Xu, Qxu, Qxu, Qxu, Xoi, Qxu, Xoi, Xoi, Xoi, Xoi, Xu, Xu, Xu, Xu, Qxu, Gll^Fmw, Gll^Fmw, Gll^Fmw, Gll^Fdw, Gll^Fdw, Gll^Fmw, Gll^Fmw, Gll^Fdw, Gll^Fdw, Cvr^Fetd, Gll^Fmw, Qxu, Qxu, Xoi, Xu
Xu, Xu, Qxu, Qxu, Qxu, Ur, Cvr, Ur, Qxu, Qxu, Qxu, Qxu, Qxu, Qxu, Qxu, Qxu, Xoi, Xoi, Xoi, Xoi, Xu, Xu, Xu, Xu, Xu, Xoi, Xu, Xoi, Xu, Xu, Xu, Xu, Xu, Xu, Xu, Xoi, Qxu, Qxu, Gll^Fdw, Gll^Fdw, Gll^Fdw, Gll^Fdw, Gll^Fdw, Gll^Fmw, Gll^Fdw, Cvr^Fmw, 8 Kvr^Fmw, Cvr^Fmw, Qxu, Qxu, Xoi, Xu
Xu, Xu, Xu, Qxu, Qxu, Qxu, Qxu, Qxu, Xoi, Xoi, Xoi, Qxu, Qxu, Qxu, Qxu, Qxu, Xu, Xu, Xu, Xu, Xu, Xu, Xu, Xu, Xu, Xu, Xu, Xu, Xu, Xu, Xu, Xu, Xu, Xu, Xu, Xoi, Xoi, Qxu, Gll^Fmw, Gll^Fmw, Gll^Fdw, Gll^Fmw, Gll^Fmw, Gll^Fmw, Gll^Fmw, Cvr^Fdw, Cvr^Fdw, Cvr^Fdw, Qxu, Xoi, Xu, Xu
Xu, Xu, Xu, Xu, Xu, Xu, Xu, Xoi, Xu, Xu, Xu, Xoi, Xoi, Xoi, Xu, Xu, Xu, Xu, Xu, Xu, Xu, Xu, Xu, Xu, Xu, Xu, Xu, Xu, Xu, Xu, Xu, Xu, Xu, Xu, Xu, Xu, Xu, Gll^Fmw, Gll^Fmw, Gll^Fdw, Qxu, Gll^Fdw, Xoi, Gll^Fmw, Xoi, Xoi, Xoi, Qxu, Qxu, Qxu, Xu, Xu
Xu, Xu, Xu, Xu, Xu, Xu, Xu, Xu, Xu, Xu, Xu, Xu, Xu, Xu, Xu, Xu, Xu, Xu, Xu, Xu, Xu, Xu, Xu, Xu, Xu, Xu, Xu, Xu, Xu, Xu, Xu, Xu, Xu, Xu, Xu, Xu, Xu, Xu, Xu, Qxu, Xu, Xoi, Xu, Xoi, Xu, Xu, Xu, Xoi, Xu, Xu, Xu, Xu
Xu, Xu, Xu, Xu, Xu, Xu, Xu, Xu, Xu, Xu, Xu, Xu, Xu, Xu, Xu, Xu, Xu, Xu, Xu, Xu, Xu, Xu, Xu, Xu, Xu, Xu, Xu, Xu, Xu, Xu, Xu, Xu, Xu, Xu, Xu, Xu, Xu, Xu, Xu, Xu, Xu, Xu, Xu, Xu, Xu, Xu, Xu, Xu, Xu, Xu, Xu, Xu
