Rp, Rp, Uu, Uu, Xu, Xu, Xu, Xu, Xu, Xu, Xu, Xu, Xu, Xu, Xu, Xu, Xu, Xu, Xu, Xu, Wog, Wog, Wog, Xu, Xu, Xu, Xu, Xu, Xu, Xu, Xu, Xu, Xu, Xu, Xu, Xu, Xu, Xu, Xu, Xuc, Xuc, Xuc, Xuc, Xuc, Xuc, Xuc, Xuc, Xuc, Xuc, Xuc, Xuc, Xuc
Uu, Rp, Rp, Uu, Uu^Tf, Xu, Xu, Xu, Xu, Xu, Xu, Xu, Xu, Xu, Xu, Xu, Xu, Xu, Xu, Xu, Wog, Wog, Wog, Xu, Xu, Xu, Xu, Xu, Xu, Xu, Xu, Xu, Xu, Xu, Xu, Xu, Xu, Xu, Xu, Xuc, Xuc, Xuc, Xuc, Xuc, Xu, Xuc, Xuc, Xuc, Xuc, Xuc, Xuc, Xuc
Uu, Uu^Tf, Uu^Tf, Uu^Ii, Uu^Tf, Rp, Rp^Ebn, Xu, Xu, Xu, Xu, Xu, Xu, Xu, Xu, Xu, Wog, Wog, Wog, Wog, Wog, Wog, Wwg, Wwg, Wwf, Uu^Tf, Uu^Edt, Xu, Uu^Edt, Xu, Qxu, Qxu, Qxu, Qxu, Qxu, Xu, Xu, Xu, Xu, Xuc, Xu, Xu, Xu, Xu, Xu, Xu, Xu, Xuc, Xu, Xuc, Xuc, Xuc
Xu, Uu, Uu, Rp^Ii, Rp, Uu, Uu, Xu, Xu, Xu, Xu, Xu, Xu, Xu, Xu, Xu, Wog, Wog, Wog, Wog, Wog, Wog, Wwg, Wwf, Ur, Uu, Uh, Ur, Ur, Ur^Edt, Uu^Tfi, Qxu, Qxu, Qxu, Qxu, Qxu, Qxu, Xu, Xu, Xu, Xof, Xof, Wog, Wog, Wog, Xu, Wog, Xof, Xof, Xu, Xu, Xuc
Xu, Xu, Xu, Uu^Ebn, Rp, Rp, Ce, Uu^Tf, Uh, Xu, Xu, Xu, Xu, Xu, Xu, Wog, Wog, Wog, Wwg, Wwg, Wwg, Wwg, Xu, Wwf, Uh, Uu^Vu, Uu, Ur^Edt, Uu^Edt, Uu^Tfi, Ur, Uu^Edt, Ur^Edt, Uu^Vu, Uu^Tfi, Qxu, Qxu, Xu, Xu, Xof, Wog, Wog, Wwg, Wog, Chw^Edt, Wog, Wwg, Wog, Wog, Xof, Xu, Xuc
Xu, Xu, Xu, Xu, Uh, Ce, 1 Ke, Ce, Rp, Xu, Xu, Xu, Wwg, Xu, Wog, Wog, Wog, Wwg, Xu, Xu, Ur^Edt, Rp^Edt, Xu, Xu, Xu, Uh, Qxu, Ur^Edt, Qxu, Ur, Ur, Uu^Tfi, Ur, Uu^Tf, Uu^Tfi, Qxu, Xu, Xu, Xof, Xof, Wog, Wwg, Rp^Qhh, Chw^Edt, 4 Khw, Chw^Edt, Rp^Qhh, Wwg, Qxu, Xof, Xu, Xu
Xu, Xu, Xu, Xu, Uh, Ce, Ce, Ce, Rp, Uh^Ii, Uu^Ii, Wwf^Edt, Wwg^Edt, Wwg, Wog, Wog, Wog, Wwg, Xu, Uh, Isa, Uu^Tf, Xu, Xu, Xu, Qxu, Qxu, Qxu, Qxu^Bcx/, Qxu^Bcx/, Ur^Edt, Uu^Edt, Cvr, Cvr, Cvr^Edt, Ur^Edt, Xu, Xu, Xof, Wog, Wwg, Wwf^Edb, Wwf^Edb, Chw^Edt, Chw^Edt, Chw^Edt, Rp^Qhh, Wwg, Wwg, Qxu, Xu, Xu
Xu, Xu, Xu, Xu, Xu, Uh, Uu, Rp, Rp, Wwf^Bw\r, Wwf^Bw\r, Wwf^Edt, Wwg^Edt, Wog, Wog, Wog, Wwg, Wwg, Xu, Xu, Xu, Xu, Xu, Xu, Xu, Xu, Ur, Qxu^Bcx/, Qxu^Bcx/, Qxu^Bcx/, Qxu, Uh, Cvr^Edt, 5 Kvr, Cvr^Edt, Xu, Xu, Xof, Rp^Qhh, Wog, Rp^Qhh, Rp^Qhh, Wwg, Wwf^Edb, Wwf^Edb, Wwg, Wwf^Edb, Wwg, Wog, Wog, Xu, Xu
Xu, Xu, Xu, Xu, Xu, Uu^Tf, Uu^Tf, Uu, Wwf^Edt, Wwf^Bw\r, Wwf^Bw\r, Wwg^Bw\r, Wwf^Bw\r, Wwg, Wwg, Wwg, Uu^Tfi, Rp, Rp^Es, Xu, Uu^Vu, Xu, Ur, Uu^Tfi, Uu^Tf, Ur, Uu, Qxu^Bcx/, Qxu, Qxu, Qxu, Uh, Xu, Cvr^Edt, Xu, Xu, Xu, Xof, Rp^Qhh, Wwf^Edb, Xu, Xu, Uu^Edt, Uu^Edt, Xof, Wwf^Edb, Rp^Qhh, Wwg, Wog, Wog, Xu, Xu
Xu, Xu, Xu, Xu, Xu, Uu, Wwf^Edt, Wwf^Edt, Wwg^Edt, Wwg^Edt, Wwf^Edt, Wwg^Bw\r, Wwf^Bw\r, Rp, Ur^Edt, Cvr, Uu, Uu^Tfi, Rp, Rp^Es, Rp^Edt, Uh^Edt, Uh^Edt, Uu^Tfi, Rp^Es, Ur, Xu, Uh^Edt, Xu, Xu, Xu, Xu, Xu, Xu, Xu, Xu, Xof, Wwg, Wwf^Edb, Wwf^Edb, Xu, Ur, Rp^Qhh, Uu^Edt, Xof, Wwg, Wwg, Rp^Qhh, Qxu, Qxu, Xu, Xu
Xu, Xu, Xu, Xu, Wwg, Wwf^Edt, Wwg, Wwf^Edt, Wwg^Edt, Wwf^Edt, Wwg, Wwg, Uu^Vu, Rp^Edt, Ur^Edt, Uh, Uh, Uu, Rp^Es, Cvr, Rp, Uh, Uh^Edt, Rp^Es, Ur^Es, Uu^Vu, Xu, Xu, Xu, Xu, Xu, Xu, Xuc, Xu, Xu, Xu, Xof, Wog, Rp^Qhh, Xu, Isa, Rp^Qhh, Uh, Xof, Wog, Wog, Wwf^Edb, Rp^Qhh, Qxu, Qxu, Xu, Xu
Xu, Xu, Xu, Xu, Wog, Wog, Wog, Wwg, Wwf^Edt, Wwf^Edt, Uu^Edt, Ur^Edt, Rp^Es, Rp^Es, Rp^Es, Uu^Tfi, Ur, Rp^Ebn, Uu^Tfi, Uu, Rp, Uu^Tfi, Rp^Edt, Rp^Es, Uu^Edt, Uh, Uh^Edt, Xu, Xu, Xuc, Xu, Xu, Xu, Xu, Xu, Xof, Wwg, Wog, Rp^Qhh, Xu, Uu^Tf, Uh, Xu, Xof, Wwg, Wwf^Edb, Rp^Qhh, Qxu, Qxu, Xu, Xu, Xu
Xu, Xu, Xu, Wog, Wog, Wog, Wog, Wwg, Wwg, Uu, Uh, Rp^Edt, Ur, Ur^Es, Rp, Uu^Tfi, Uu^Vu, Rp^Es, Cvr^Edb, Cvr^Edb, Cvr^Edb, Rp^Edt, Rp^Ebn, Uu, Rp, Rp, Uh, Xu, Xu, Xu, Xof, Xof, Xof, Xof, Xu, Xof, Uu, Wwf^Edb, Uu, Xu, Xu, Uu, Xof, Xof, Wog, Rp^Qhh, Qxu, Qxu, Qxu, Xu, Xu, Xu
Xu, Xu, Wog, Wog, Wog, Wog, Xu, Wwg, Uu^Vu, Uh, Ur^Es, Uh, Uu^Tfi, Uu^Vu, Rp, Rp, Rp, Rp, Cvr^Edb, 6 Kvr, Cvr^Edb, Ur, Ur, Rp, Uu^Tfi, Ur, Xu, Xu, Xu, Xof, Uu^Es, Rp^Edb, Ur, Cvr, Uu, Rp^Edb, Rp^Edb, Uu^Tfi, Uu^Tfi, Xof, Xof, Xu, Xof, Wog, Wwf^Edb, Rp^Qhh, Qxu, Qxu, Qxu, Xof, Xu, Xu
Wog, Wog, Wog, Wog, Wog, Xu, Xu, Rp, Rp, Rp^Es, Rp^Es, Uu^Tf, Rp^Edt, Rp, Cvr, Uu, Uu^Tfi, Uh, Uh, Cvr^Edb, Rp^Edt, Ur, Uu^Edt, Uu^Tfi, Uu, Uu, Xof, Xu, Xof, Xof, Uu^Es, Uu^Vu, Ur^Edb, Rp^Edb, Uh, Uh, Xu, Uu, Rp, Uu, Uh, Xof, Uu, Ur^Edb, Ur, Xu, Xu, Qxu, Qxu, Xof, Xu, Xu
Wog, Wog, Wog, Wog, Xu, Xu, Xu, Xu, Uu, Uu^Edt, Uu^Edt, Rp^Edt, Ur^Edt, Ur^Edt, Rp, Uu, Ur, Uu^Tfi, Uh^Ebn, Uh, Rp, Uu^Vu, Ur, Uu^Tf, Cvr, Xof, Xof, Xof, Qxu, Cvr^Edb, 7 Kvr, Ur, Rp^Es, Uu, Cvr, Xu, Xu, Xu, Rp^Edb, Rp^Edb, Ur, Uu^Tfi, Rp, Uu^Tf, Xu, Xu, Qxu, Qxu, Qxu, Xof, Xu, Xu
Wog, Wog, Rp, Wog, Isa, Isa, Rp, Xu, Xu, Uh, Uh, Uh, Ur, Uu^Tfi, Ur, Rp^Es, Rp, Rp, Rp^Es, Rp^Es, Ur^Es, Ur, Cvr^Edb, Cvr^Edb, Uu^Xo, Xof, Xof, Xof, Qxu, Cvr^Edb, Cvr^Edb, Cvr^Edb, Uu, Rp^Es, Xu, Xu, Xu, Xu, Xu, Uu^Tfi, Uu, Cvr, Cvr, Uu, Qxu, Xu, Qxu, Qxu, Xof, Xof, Xu, Xu
Xu, Xu, Uu, Rp, Ur, Gll^Fet, Rp, Xu, Xu, Xu, Xu, Xu, Xu, Uu^Tf, Xu, Uu^Vu, Uh, Uu^Tf, Xu, Ur^Es, Xof, Cvr, Uu^Xo, Uu^Xo, Cvr^Edb, Cvr^Edb, Qxu, Qxu, Qxu^Bcx/, Qxu^Bcx/, Qxu^Bcx/, Qxu^Bcx/, Qxu, Xu, Xu, Xu, Xof, Xu, Xof, Ur, Uh, Xu, Xu, Xu, Xu, Qxu, Qxu, Qxu, Xu, Xu, Xu, Xu
Xu, Xu, Xu, Uu, Xu, Ur, Xu, Xu, Xu, Xu, Xu, Xu, Xu, Xu, Xu, Xu, Xu, Xu, Xu, Xu, Xu, Xof, Cvr, Cvr^Edb, Rp, Ur, Qxu^Bcx/, Qxu^Bcx/, Qxu^Bcx/, Qxu^Bcx/, Qxu, Qxu, Qxu, Xof, Xof, Xof, Uu^Tfi, Xof, Rp, Uu, Uh, Xu, Xu, Xu, Xu, Xu, Qxu, Qxu, Xu, Xu, Xu, Xu
Xu, Xu, Xu, Xu, Qxu, Xu, Qxu, Uu^Vu, Rp, Rb^Edb, Cvr^Edb, Xu, Xu, Xu, Xu, Xu, Xu, Xu, Xu, Xu, Xos, Xof, Qxu, Rp, Ur^Edb, Uu^Edb, Rp, Qxu^Bcx/, Qxu, Qxu, Qxu, Qxu, Rp, Uu^Em, Uu^Es, Uu, Ur, Uh, Ur^Edb, Rp^Es, Xof, Xu, Xu, Xu, Xu, Xu, Qxu, Qxu, Xu, Xu, Xu, Xu
Xu, Xu, Xu, Qxu, Qxu, Qxu, Qxu, Qxu, Cvr^Edb, Rb, Rb, Xu, Xu, Xu, Xu, Xu, Xu, Xu, Xof, Xof, Xof, Xof, Qxu, Qxu, Qxu, Ur, Rp^Edb, Ur^Edb, Qxu, Qxu, Xu, Xu, Rp^Em, Rp^Es, Uh, Uh^Edb, Cvr, Uu^Edb, Uh, Rp^Es, Xof, Xu, Uu^Vu, Xu, Xu, Xu, Uh, Qxu, Xu, Xu, Xu, Xu
Xu, Xu, Xu, Qxu, Qxu, Qxu, Qxu, Cvr^Edb, 3 Kvr, Cvr^Edb, Rp^Edb, Rp^Ebn, Xof, Xu, Xu, Xu, Xof, Xof, Qxu, Qxu, Qxu, Qxu, Qxu, Qxu, Qxu, Ur, Rp, Rp, Ur, Qxu, Xu, Xu, Xu, Cvr, Rp, Rp^Edb, Ur^Edb, Uu, Uu^Tfi, Xof, Xof, Uh^Eb, Uh, Rp, Ur^Em, Uh, Uu^Tfi, Xu, Xu, Xu, Xu, Xu
Xu, Xu, Xu, Qxu, Qxu, Qxu, Ur, Cvr^Edb, Cvr^Edb, Cvr^Edb, Uu, Uu, Rp, Xof, Xof, Xu, Uh, Qxu, Qxu, Qxu, Qxu, Qxu, Qxu, Qxu, Uh, Uh, Uu^Tfi, Uu, Rp, Rp, Uh, Xu, Xu, Xu, Uu^Tfi, Uu^Tfi, Ur, Uh, Ur, Xof, Xof, Xof, Xu, Rp, Uu, Uu, Xu, Xu, Xu, Xu, Xu, Xu
Xu, Xu, Xu, Xu, Qxu, Qxu, Qxu, Uu^Ebn, Uu, Rp, Rp^Edb, Rp^Edb, Cvr, Uu, Xof, Xof, Uh, Uu^Vu, Uu, Rp, Rp^Edb, Qxu, Qxu, Qxu, Rp, Uu, Rb, Ur, Rp, Uu^Tf, Uh, Xof, Xof, Uu, Uu^Em, Ur, Xu, Cvr, Ur, Uu, Xof, Xof, Xu, Xu, Uu^Tfi, Rp, Xof, Xu, Xu, Xu, Xu, Xu
Xu, Xu, Xu, Xu, Qxu, Qxu, Qxu, Uu^Vu, Rp, Ur, Rp, Rb, Ur, Rb, Uu^Tfi, Xof, Ur, Uu^Tf, Uu^Tfi, Rb, Rb^Edb, Uu^Edb, Uu^Tfi, Ur, Uu, Rp, Uu^Tf, Uu^Vu, Ur, Uu, Rp, Uu^Tfi, Ur, Ur, Ur^Es, Rp^Es, Xu, Xu, Uu, Uh, Rp^Em, Xof, Uh, Xu, Rp, Rp, Xof, Xu, Xu, Xu, Xu, Xu
Xu, Xu, Xu, Xu, Xu, Qxu, Qxu, Qxu, Xu, Cvr, Xu, Uu, Uu^Vu, Ur^Es, Isa^Edb, Rp^Edb, Uu^Tfi, Isa, Uu, Xu, Xof, Ur, Isa, Uu, Xof, Uh, Uh, Uu^Tf, Kvr, Cvr^Edb, Uh, Rp, Uu, Uh, Uh, Rp, Xu, Xu, Xu, Rp, Uu^Tfi, Rp, Uu, Uh, Uu^Em, Ur, Xof, Xu, Xu, Xu, Xu, Xu
Xu, Xu, Xu, Xu, Xu, Xu, Xu, Xu, Xuc, Xu, Xu, Xu, Xu, Xu, Xu, Rp, Rb, Uu^Tf, Xu, Xof, Xof, Isa, Uu, Xof, Xu, Xu, Uh, Cvr^Edb, Cvr^Edb, Uu, Ur, Rp, Ss, Uu^Tf, Sm^Qhu, Xu, Xu, Xu, Xu, Xu, Xu, Uu^Tf, Uu^Em, Ur, Rp, Rp, Xof, Xos, Xu, Xu, Xu, Xu
Xu, Xu, Xu, Xu, Xuf, Xuf, Gll^Qhhf, Xu, Xu, Xu, Xuf, Xu, Xuf, Xuf, Xuf, Uu, Rb^Es, Rb^Edb, Rp^Edb, Xu, Rb, Isa, Uu, Xof, Xu, Xu, Ur^Em, Rp, Rp, Uu^Tf, Uu^Tf, Sm^Qhu, Ss^Em, Ss, Sm^Qhu, Sm^Qhu, Xu, Xu, Xu, Xu, Xu, Uh, Uh, Ur, Uu^Em, Xof, Xof, Xoc, Xu, Xu, Xu, Xu
Xu, Xu, Xu, Xuf, Qxu, Gll^Qhhf, Gll^Fetd, Gll^Qhuf, Qxu, Qxu, Qxu, Xuf, Qxu, Xuf, Xuf, Xuf, Xu, Uu^Es, Uu, Rp, Rb, Uu, Xof, Xof, Xof, Qxu, Ur, Uu, Ss^Em, Ss^Bw\r, Ss, Sm^Qhu, Ss, Gll^Qhhf, Gll^Qhhf, Gll^Qhhf, Ss^Em, Xu, Gll^Qhhf, Xu, Xu, Xu, Uu^Tf, Uu^Tfi, Rp, Xof, Xof, Xu, Xu, Xu, Xu, Xu
Xu, Xu, Xuf, Xuf, Qxu, Gll^Qhhf, Gll^Qhuf, Gll^Qhuf, Gll^Fdw, Qxu, Gll^Qhuf, Qxu, Qxu, Qxu, Uu, Uu^Edb, Rp^Es, Xu, Xu, Rp, Qxu, Qxu, Qxu, Xof, Qxu, Qxu, Uh, Uh, Sm^Qhu, Sm^Qhu, Gll^Qhhf, Sm, Sm^Bw\r, Sm, Ss^Em, Sm^Qhu, Sm^Qhu, Ss, Gll^Qhhf, Gll^Qhhf, Xu, Xu, Uh, Uu^Vu, Rp, Xu, Xu, Xu, Xu, Xu, Xu, Xu
Xu, Xu, Xuf, Qxu, Qxu, Qxu, Gll^Fdw, Hhd^Fmw, Hhd^Fdw, Gll^Fdw, Gll^Fmw, Gll^Qhuf, Qxu, Qxu, Rp^Edb, Rp^Edb, Rp, Rp, Xuf, Xuf, Xuf, Qxu, Qxu, Qxu, Qxu, Ss^Em, Ss, Sm^Qhu, Ss^Em, Ss, Gll^Qhhf, Gll^Qhhf, Sm^Qhu, Ss, Gll^Qhhf, Gll^Qhhf, Sm^Qhu, Ss, Sm, Sm, Xu, Xu, Xu, Uh^Em, Rp, Xu, Xu, Xu, Xu, Xu, Xu, Xu
Xuc, Xu, Qxu, Qxu, Qxu, Gll^Fdw, Gll^Qhuf, Hhd^Fdw, Gll^Qhuf, Gll^Qhhf, Hhd^Fmw, Hhd^Em, Rp^Es, Rp, Rp^Es, Rp^Es, Qxu, Uu^Edb, Qxu, Xuf, Xuf, Qxu, Qxu, Qxu, Uu^Tfi, Gll^Qhhf, Gll^Qhhf, Sm^Qhu, Gll^Qhhf, Ss, Sm^Qhu, Sm^Qhu, Gll^Qhhf, Ss, Sm^Qhu, Sm^Qhu, Sm^Bw\r, Gll^Qhhf, Rb, Xu, Xu, Xu, Xof, Ur, Ur, Xu, Xu, Xu, Xu, Xu, Xu, Xu
Xu, Xu, Qxu, Qxu, Qxu, Gll^Fmw, Cvr, Gll^Qhuf, Hhd^Em, Gll^Qhhf, Rp, Rp^Es, Rp^Edb, Rp^Edb, Hhd^Em, Qxu, Qxu, Qxu, Qxu, Xuf, Xu, Xuf, Qxu, Qxu, Ur^Em, Ur^Es, Uu^Es, Sm^Qhu, Gll^Qhhf, Gll^Qhhf, Sm^Qhu, Ss, Ss, Gll^Qhhf, Sm^Qhu, Ss, Ur, Ur, Rb, Xof, Xof, Xof, Cvr, Rb, Uu, Xof, Xof, Xu, Xu, Xu, Xu, Xu
Xu, Qxu, Qxu, Qxu, Ur^Edt, Ur^Edt, Gll^Fmw, Ur^Edt, Ur^Edt, Hhd^Es, Hhd^Es, Rp, Gll^Fmw, Hhd^Es, Gll^Fmw, Gll^Qhuf, Qxu, Qxu, Gll^Qhhf, Xu, Xu, Xuf, Qxu, Qxu, Qxu, Uu^Tf, Uu^Tfi, Sm^Qhu, Ss, Sm^Qhu, Gll^Qhhf, Sm^Qhu, Ss^Em, Sm^Qhu, Ss, Ss^Em, Ur, Uu^Tf, Uu^Tfi, Rb, Uh, Uh^Em, Rb, Rb, Uu^Tfi, Cvr, Xof, Xu, Xof, Xu, Xu, Xu
Xu, Qxu, Qxu, Cvr, Gll^Fmw, Gll^Fdw, Gll^Fp, Gll^Fmw, Gll^Fmw, Cvr, Hhd^Es, Gll^Fmw, Gll^Qhhf, Gll^Fdw, Gll^Fmw, Gll^Qhuf, Gll^Qhuf, Gll^Qhhf, Gll^Qhuf, Xu, Xu, Xuf, Xuf, Qxu, Qxu, Qxu, Uh, Gll^Fmw, Ss^Em, Sm^Qhu, Gll^Qhhf, Gll^Qhhf, Gll^Qhhf, Sm^Qhu, Uu^Em, Uu, Xof, Gll^Fdw, Uu, Uu, Gll^Fdw, Gll^Fdw, Gll^Fdw, Gll^Qhhf, Gll^Qhhf, Uu, Gll^Fmw, Xof, Qxu, Xof, Xu, Xu
Xu, Qxu, Qxu, Ur^Edt, Gll^Fmw, Gll^Fp, 2 Gll^Fetd, Gll^Fp, Gll^Fdw, Ur^Edt, Gll^Fdw, Gll^Fdw, Gll^Qhhf, Gll^Qhhf, Hhd^Fdw, Hhd^Fmw, Gll^Fdw, Gll^Fdw, Gll^Qhuf, Gll^Qhuf, Xu, Xu, Xuf, Qxu, Qxu, Qxu, Qxu, Uh, Qxu, Ss, Qxu, Sm^Qhu, Sm^Qhu, Sm^Qhu, Uh, Xof, Xof, Xof, Gll^Fdw, Gll^Fdw, Gll^Qhhf, Gll^Qhhf, Gll^Fmw, Gll^Qhhf, Gll^Fmw, Gll^Fdw, Gll^Fmw, Gll^Qhuf, Gll^Qhuf, Qxu, Xu, Xu
Xu, Qxu, Qxu, Ur^Edt, Gll^Fmw, Gll^Fp, Gll^Fp, Gll^Fp, Gll^Fdw, Ur^Edt, Gll^Qhuf, Hhd^Fmw, Hhd^Fmw, Hhd^Fdw, Gll^Qhuf, Hhd^Fdw, Gll^Qhhf, Gll^Fmw, Gll^Fetd, Gll^Qhhf, Xu, Xu, Xu, Qxu, Qxu, Qxu, Qxu, Qxu, Qxu, Qxu, Qxu, Qxu, Xu, Uh^Em, Xu, Xu, Xof, Gll^Fmw, Gll^Fdw, Gll^Fdw, Gll^Fetd, Gll^Fmw, Gll^Fmw, Gll^Fmw, Gll^Qhhf, Gll^Fmw, Gll^Fdw, Gll^Fmw, Gll^Qhuf, Qxu, Xof, Xu
Xu, Xu, Qxu, Cvr, Ur^Edt, Gll^Fdw, Gll^Fmw, Gll^Fmw, Ur^Edt, Cvr, Qxu, Gll^Qhuf, Qxu, Gll^Qhuf, Qxu, Hhd^Fmw, Gll^Qhhf, Gll^Qhhf, Gll^Fmw, Gll^Qhhf, Xu, Xu, Xu, Qxu, Qxu, Qxu, Xof, Qxu, Xof, Xof, Xof, Xof, Xu, Xu, Xu, Xu, Qxu, Gll^Fmw, Gll^Qhuf, Gll^Qhuf, Gll^Fdw, Gll^Fdw, Gll^Fmw, Gll^Qhhf, Gll^Fdw, Gll^Fdw, Cvr^Fetd, Gll^Fmw, Qxu, Qxu, Xof, Xu
Xu, Xu, Qxu, Qxu, Qxu, Ur^Edt, Cvr, Ur^Edt, Qxu, Qxu, Qxu, Qxu, Qxu, Qxu, Qxu, Qxu, Xuf, Xuf, Xuf, Xuf, Xu, Xu, Xu, Xu, Xu, Xof, Xu, Xof, Xu, Xu, Xu, Xu, Xu, Xu, Xu, Xof, Qxu, Qxu, Gll^Fdw, Gll^Qhuf, Gll^Fdw, Gll^Fdw, Gll^Fdw, Gll^Fmw, Gll^Fdw, Cvr^Fmw, 8 Kvr^Fmw, Cvr^Fmw, Qxu, Qxu, Xof, Xu
Xu, Xu, Xu, Qxu, Qxu, Qxu, Qxu, Qxu, Xuf, Xuf, Xuf, Qxu, Qxu, Qxu, Qxu, Qxu, Xu, Xu, Xu, Xu, Xu, Xu, Xu, Xu, Xu, Xu, Xu, Xu, Xu, Xu, Xu, Xu, Xu, Xu, Xu, Xof, Xof, Qxu, Gll^Qhhf, Gll^Fmw, Gll^Qhuf, Gll^Qhuf, Gll^Qhuf, Gll^Fmw, Gll^Fmw, Cvr^Fdw, Cvr^Fdw, Cvr^Fdw, Qxu, Qxu, Xu, Xu
Xu, Xu, Xu, Xu, Xu, Xu, Xu, Xuf, Xu, Xu, Xu, Xuf, Xuf, Xuf, Xu, Xu, Xu, Xu, Xu, Xu, Xu, Xu, Xu, Xu, Xu, Xu, Xu, Xu, Xu, Xu, Xu, Xu, Xu, Xu, Xu, Xof, Xu, Gll^Qhhf, Gll^Qhhf, Gll^Qhhf, Qxu, Gll^Qhuf, Xof, Gll^Fmw, Qxu, Qxu, Qxu, Qxu, Qxu, Qxu, Xu, Xu
Xu, Xu, Xu, Xu, Xu, Xu, Xu, Xu, Xu, Xu, Xu, Xu, Xu, Xu, Xu, Xu, Xu, Xu, Xu, Xu, Xu, Xu, Xu, Xu, Xu, Xu, Xu, Xu, Xu, Xu, Xu, Xu, Xu, Xu, Xu, Xu, Xu, Xu, Xu, Qxu, Xu, Xof, Xu, Xof, Xu, Qxu, Xu, Qxu, Xu, Xu, Xu, Xu
Xu, Xu, Xu, Xu, Xu, Xu, Xu, Xu, Xu, Xu, Xu, Xu, Xu, Xu, Xu, Xu, Xu, Xu, Xu, Xu, Xu, Xu, Xu, Xu, Xu, Xu, Xu, Xu, Xu, Xu, Xu, Xu, Xu, Xu, Xu, Xu, Xu, Xu, Xu, Xu, Xu, Xu, Xu, Xu, Xu, Xu, Xu, Xu, Xu, Xu, Xu, Xu
