border_size=1
usage=map

Rp, Rp, Uu, Uu, Xu, Xu, Xu, Xu, Xu, Xu, Xu, Xu, Xu, Xu, Xu, Xu, Xu, Xu, Xu, Xu, Wog, Wog, Wog, Xu, Xu, Xu, Xu, Xu, Xu, Xu, Xu, Xu, Xu, Xu, Xu, Xu, Xu, Xu, Xu, Xuc, Xuc, Xuc, Xuc, Xuc, Xuc, Xuc, Xuc, Xuc, Xuc, Xuc, Xuc, Xuc
Uu, Rp, Rp, Uu, Uu^Uf, Xu, Xu, Xu, Xu, Xu, Xu, Xu, Xu, Xu, Xu, Xu, Xu, Xu, Xu, Xu, Wog, Wog, Wog, Xu, Xu, Xu, Xu, Xu, Xu, Xu, Xu, Xu, Xu, Xu, Xu, Xu, Xu, Xu, Xu, Xuc, Xuc, Xuc, Xuc, Xuc, Xu, Xuc, Xuc, Xuc, Xuc, Xuc, Xuc, Xuc
Uu, Uu^Uf, Uu^Ufi, Uu^Ii, Uu^Ufi, Rp, Rp, Xu, Xu, Xu, Xu, Xu, Xu, Xu, Xu, Xu, Wog, Wog, Wog, Wog, Wog, Wog, Wwg, Wwg, Wwf, Uu^Uf, Uu, Xu, Uu, Xu, Qxu, Qxu, Qxu, Qxu, Qxu, Xu, Xu, Xu, Xu, Xuc, Xuc, Xu, Xu, Xu, Xu, Xu, Xu, Xuc, Xu, Xuc, Xuc, Xuc
Xu, Uu, Uu, Rp^Ii, Rp, Uu, Uu, Xu, Xu, Xu, Xu, Xu, Xu, Xu, Xu, Xu, Wog, Wog, Wog, Wog, Wog, Wog, Wwg, Wwf, Ur, Uu, Uh, Ur, Ur, Ur, Uu^Uf, Qxu, Qxu, Qxu, Qxu, Qxu, Qxu, Xu, Xu, Xu, Xos, Xos, Wog, Wog, Wog, Xu, Wog, Xos, Xos, Xu, Xu, Xuc
Xu, Xu, Xu, Uu, Rp, Rp, Ce, Uu^Uf, Uh, Xu, Xu, Xu, Xu, Xu, Xu, Wog, Wog, Wog, Wwg, Wwg, Wwg, Wwg, Xu, Wwf, Uh, Ur, Uu, Ur, Uu, Uu^Uf, Ur, Uu, Ur, Ur, Uu^Ufi, Qxu, Qxu, Xu, Xu, Xos, Wog, Wog, Wwg, Wog, Chw, Wog, Wwg, Wog, Wog, Xos, Xu, Xuc
Xu, Xu, Xu, Xu, Uh, Ce, 1 Ke, Ce, Rp, Xu, Xu, Xu, Wwg, Xu, Wog, Wog, Wog, Wwg, Xu, Xu, Xu, Xu, Xu, Xu, Xu, Uh, Qxu, Uu, Qxu, Ur, Ur, Uu^Uf, Ur, Uu^Uf, Uu^Uf, Qxu, Xu, Xu, Xos, Xos, Wog, Wwg, Rp, Chw, 4 Khw, Chw, Rp, Wwg, Qxu, Xos, Xu, Xu
Xu, Xu, Xu, Xu, Uh, Ce, Ce, Ce, Rp, Uh^Ii, Uu^Ii, Wwf, Wwg, Wwg, Wog, Wog, Wog, Wwg, Xu, Xu, Xu, Xu, Xu, Xu, Xu, Qxu, Qxu, Qxu, Qxu, Qxu, Uu, Uu, Cud, Cud, Cud, Uu, Xu, Xu, Xos, Wog, Wwg, Wwg, Wwg, Chw, Chw, Chw, Rp, Wwg, Wwg, Qxu, Xu, Xu
Xu, Xu, Xu, Xu, Xu, Uh, Uu, Rp, Rp, Wwf^Ii, Wwf, Wwf, Wwg, Wog, Wog, Wog, Wwg, Wwg, Xu, Xu, Xu, Xu, Xu, Xu, Xu, Xu, Uu, Qxu, Qxu^Bcx/, Qxu^Bcx/, Qxu, Uh, Cud, 5 Kud, Cud, Xu, Xu, Xos, Rp, Wog, Rp, Rp, Wog, Wog, Wog, Wwg, Wwg, Wwg, Wog, Wog, Xu, Xu
Xu, Xu, Xu, Xu, Xu, Uu^Uf, Uu^Uf, Uu, Wwf, Wwf, Wwf, Wwg, Wwf, Wwg, Wwg, Wwg, Uu^Uf, Rp, Rp, Xu, Uu^Vu, Xu, Uu, Uu^Uf, Uu^Uf, Ur, Uu, Qxu^Bcx/, Qxu, Qxu, Qxu, Uh, Xu, Cud, Xu, Xu, Xu, Xos, Rp, Wwg, Xu, Xu, Xu, Xu, Xu, Wwg, Rp, Wwg, Wog, Wog, Xu, Xu
Xu, Xu, Xu, Xu, Xu, Uu, Wwf, Wwf, Wwg, Wwg, Wwf, Wwg, Wwf, Rp, Uu, Uh, Uu, Uu^Uf, Rp, Rp, Rp, Uh, Uh, Uu^Uf, Rp, Ur, Xu, Uh, Xu, Xu, Xu, Xu, Xu, Xu, Xu, Xu, Xu, Wwg, Wwg, Wwg, Xu, Xu, Xu, Xu, Xu, Wwg, Wwg, Rp, Qxu, Qxu, Xu, Xu
Xu, Xu, Xu, Xu, Wwg, Wwf, Wwg, Wwf, Wwg, Wwf, Wwg, Wwg, Uu^Vu, Rp, Uu, Uh, Uh, Uu, Rp, Uu, Rp, Uh, Uh, Rp, Uu, Uu^Vu, Xu, Xu, Xu, Xu, Xu, Xu, Xuc, Xu, Xu, Xu, Xu, Wog, Rp, Xu, Xu, Xu, Xu, Xu, Wog, Wog, Wwg, Rp, Qxu, Qxu, Xu, Xu
Xu, Xu, Xu, Xu, Wog, Wog, Wog, Wwg, Wwf, Wwf, Uu, Ur, Rp, Rp, Rp, Uu^Uf, Uu, Rp, Uu^Uf, Uu, Rp, Uu^Uf, Rp, Rp, Uu, Uh, Uh, Xu, Xu, Xuc, Xuc, Xuc, Xuc, Xuc, Xu, Xu, Wwg, Wog, Rp, Xu, Xu, Xu, Xu, Xu, Wwg, Wwg, Rp, Qxu, Qxu, Xu, Xu, Xu
Xu, Xu, Xu, Wog, Wog, Wog, Wog, Wwg, Wwg, Uu, Uh, Rp, Ur, Ur, Rp, Uu^Uf, Uu^Vu, Rp, Ce, Ce, Ce, Rp, Rp, Uu, Rp, Rp, Uh, Xu, Xu, Xuc, Xos, Xos, Xos, Xos, Xu, Xu, Uu, Wwg, Xu, Xu, Xu, Xu, Xu, Xu, Wog, Rp, Qxu, Qxu, Qxu, Xu, Xu, Xu
Xu, Xu, Wog, Wog, Wog, Wog, Xu, Wwg, Uu^Vu, Uh, Uu, Uh, Uu^Uf, Uu^Vu, Rp, Rp, Rp, Rp, Ce, 6 Ket, Ce, Ur, Uu, Rp, Uu^Uf, Uu, Xuc, Xu, Xu, Xos, Uu, Rp, Ur, Cud, Uu, Rp, Uu, Uu^Ufi, Uu^Uf, Xu, Xu, Xu, Xu, Wog, Wwg, Rp, Qxu, Qxu, Qxu, Xos, Xu, Xu
Wog, Wog, Wog, Wog, Wog, Xu, Xu, Rp, Rp, Rp, Rp, Uu^Uf, Rp, Rp, Ur, Uu, Uu^Uf, Uh, Uh, Ce, Rp, Ur, Uu, Uu^Uf, Uu, Uu, Xos, Xu, Xos, Xos, Uu, Uu^Vu, Ur, Rp, Uh, Uh, Xu, Uu, Rp, Uu, Xu, Xu, Uu, Ur, Ur, Xu, Xu, Qxu, Qxu, Xos, Xu, Xu
Wog, Wog, Wog, Wog, Xu, Xu, Xu, Xu, Uu, Uu, Uu, Rp, Uu, Ur, Rp, Uu, Uu, Uu^Uf, Uh, Uh, Rp, Uu^Vu, Ur, Uu^Uf, Cud, Xos, Xos, Xos, Qxu, Cud, 7 Kud, Ur, Rp, Uu, Cud, Xu, Xu, Xu, Uu, Uu, Ur, Xu, Uu, Uu^Ufi, Xu, Xu, Qxu, Qxu, Qxu, Xos, Xu, Xu
Wog, Wog, Xu, Wog, Xu, Xu, Xu, Xu, Xu, Uh, Uh, Uh, Uu, Uu^Uf, Ur, Rp, Rp, Rp, Rp, Rp, Ur, Ur, Cud, Cud, Cud^Xo, Xos, Xol, Xol, Qxu, Cud, Cud, Cud, Uu, Uu, Xu, Xu, Xu, Xu, Xu, Uu^Uf, Uu, Cud, Cud, Uu, Qxu, Xu, Qxu, Qxu, Xos, Xos, Xu, Xu
Xu, Xu, Xu, Xu, Xu, Xu, Xu, Xu, Xu, Xu, Xu, Xu, Xu, Uu^Uf, Xu, Uu^Vu, Uh, Uu^Uf, Xu, Ur, Xos, Cud, Cud^Xo, Cud^Xo, Cud, Cud, Qxu, Qxu, Qxu, Qxu, Qxu, Qxu, Qxu, Xu, Xu, Xu, Xu, Xu, Xu, Uu, Uh, Xu, Xu, Xu, Xu, Qxu, Qxu, Qxu, Xu, Xu, Xu, Xu
Xu, Xu, Xu, Xu, Xuc, Xu, Xu, Xu, Xu, Xuc, Xuc, Xu, Xu, Xu, Xu, Xu, Xu, Xu, Xu, Xu, Xu, Xos, Cud, Cud, Rp, Ur, Qxu, Qxu, Qxu, Qxu, Qxu, Qxu, Qxu, Xu, Xu, Xu, Uu^Uf, Xu, Rp, Uu, Uh, Xu, Xu, Xu, Xu, Xu, Qxu, Qxu, Xu, Xu, Xu, Xu
Xu, Xu, Xuc, Xuc, Qxu, Xu, Qxu, Uu^Vu, Rp, Rb, Cud, Xuc, Xu, Xu, Xu, Xu, Xu, Xu, Xu, Xu, Xos, Xos, Qxu, Rp, Ur, Uu, Rp, Qxu, Qxu, Qxu, Qxu, Qxu, Rp, Uu, Uu, Uu, Ur, Uh, Uu, Rp, Xos, Xu, Xu, Xu, Xu, Xu, Qxu, Qxu, Xu, Xu, Xu, Xu
Xu, Xu, Xuc, Qxu, Qxu, Qxu, Qxu, Qxu, Cud, Rb, Rb, Xuc, Xuc, Xu, Xu, Xu, Xu, Xu, Xos, Xos, Xol, Xol, Qxu, Qxu, Qxu, Uu, Rp, Ur, Qxu, Qxu, Xu, Xu, Rp, Rp, Uh, Uh, Cud, Uu, Uh, Rp, Xos, Xu, Uu^Vu, Xu, Xu, Xu, Uh, Qxu, Xu, Xu, Xu, Xu
Xu, Xu, Xuc, Qxu, Qxu, Qxu, Qxu, Cud, 3 Kud, Cud, Rp, Rp, Xos, Xu, Xu, Xu, Xos, Xos, Qxu, Qxu, Qxu, Qxu, Qxu, Qxu, Qxu, Ur, Rp, Rp, Uu, Qxu, Xu, Xu, Xu, Cud, Rp, Rp, Ur, Uu, Uu^Uf, Xos, Xos, Uh, Uh, Rp, Uu, Uh, Uu^Uf, Xu, Xu, Xu, Xu, Xu
Xu, Xu, Xuc, Qxu, Qxu, Qxu, Ur, Cud, Cud, Cud, Uu, Uu, Rp, Xos, Xos, Xu, Uh, Qxu, Qxu, Qxu, Qxu, Qxu, Qxu, Qxu, Uh, Uh, Uu^Uf, Uu, Rp, Rp, Uh, Xu, Xu, Xu, Uu^Ufi, Uu^Uf, Ur, Uh, Uh, Xos, Xos, Xos, Xu, Rp, Uu, Uu, Xu, Xu, Xu, Xu, Xu, Xu
Xu, Xu, Xu, Xu, Qxu, Qxu, Qxu, Uu, Uu, Rp, Rp, Rp, Cud, Uu, Xos, Xos, Uh, Uu^Vu, Uu, Rp, Rp, Qxu, Qxu, Qxu, Rp, Uu, Rb, Uu, Rp, Uu^Uf, Uh, Xu, Xu, Uu, Uu, Uu, Xu, Cud, Uu, Uu, Xos, Xos, Xu, Xu, Uu^Ufi, Rp, Xos, Xu, Xu, Xu, Xu, Xu
Xu, Xu, Xu, Xu, Qxu, Qxu, Qxu, Uu^Vu, Rp, Uu, Rp, Rb, Ur, Rb, Uu^Uf, Xos, Xu, Uu^Uf, Uu^Ufi, Rb, Rb, Uu, Uu^Ufi, Uu, Uu, Rp, Uu^Uf, Uu^Vu, Uu, Uu, Rp, Uu^Ufi, Ur, Ur, Ur, Rp, Xu, Xu, Uu, Uh, Rp, Xu, Uh, Xu, Rp, Rp, Xos, Xu, Xu, Xu, Xu, Xu
Xu, Xu, Xu, Xu, Xu, Qxu, Qxu, Qxu, Xu, Cud, Xu, Uu, Uu^Vu, Uu, Urb, Rp, Uu^Uf, Xu, Xu, Xu, Xos, Uu, Urb, Uu, Xos, Uh, Uh, Uu^Ufi, Rb, Ur, Uh, Rp, Uu, Uh, Uh, Rp, Xu, Xu, Xu, Rp, Uu^Uf, Rp, Uu, Uh, Uu, Uu, Xos, Xu, Xu, Xu, Xu, Xu
Xu, Xu, Xu, Xu, Xu, Xu, Xu, Xuc, Xuc, Xu, Xu, Xu, Xu, Xu, Xu, Rp, Rb, Uu^Uf, Xu, Xos, Xos, Urb, Uu, Xos, Xu, Xu, Uh, Rp, Rb, Uu, Uu, Rp, Sm, Uu^Uf, Sm, Xu, Xu, Xu, Xu, Xu, Xu, Uu^Uf, Xu, Ur, Cud, Cud, Cud, Xos, Xu, Xu, Xu, Xu
Xu, Xu, Xu, Xu, Xos, Xos, Gll^Fmw, Xu, Xu, Xuc, Xos, Xu, Xos, Xos, Xos, Uu, Rb, Rb, Rp, Xu, Rb, Ur, Uu, Xos, Xu, Xu, Ur, Rp, Rp, Uu^Uf, Uu^Uf, Sm, Sm, Sm, Sm, Sm, Xu, Xu, Xu, Xu, Xu, Xu, Xu, Ur, Cud, 8 Kud, Cud, Xos, Xu, Xu, Xu, Xu
Xu, Xu, Xu, Xos, Qxu, Gll^Fmw, Gd^Fetd, Gll^Fdw, Qxu, Qxu, Qxu, Xos, Qxu, Xos, Xos, Xos, Xu, Uu, Uu, Rp, Rb, Uu, Xos, Xos, Xu, Qxu, Ur, Uu, Sm, Sm, Sm, Sm, Sm, Sm, Rb, Rb, Sm, Xu, Rb, Xu, Xu, Xu, Uu^Uf, Uu^Uf, Rp, Cud, Xu, Xu, Xu, Xu, Xu, Xu
Xu, Xu, Xos, Xos, Qxu, Gll^Fdw, Gll^Fdw, Gll^Fmw, Gll^Fdw, Qxu, Gll^Fmw, Qxu, Qxu, Qxu, Uu, Uu, Rp, Xu, Xu, Rp, Qxu, Qxu, Qxu, Xu, Qxu, Qxu, Uh, Uh, Sm, Sm, Sm, Sm, Sm, Sm, Sm, Sm, Sm, Sm, Rb, Rb, Xu, Xu, Uh, Uu^Vu, Rp, Xu, Xu, Xu, Xu, Xu, Xu, Xu
Xu, Xu, Xos, Qxu, Qxu, Qxu, Gll^Fdw, Hhd^Fmw, Hhd^Fdw, Gll^Fdw, Gll^Fmw, Gll^Fdw, Qxu, Qxu, Rp, Rp, Rp, Rp, Xos, Xos, Xos, Qxu, Qxu, Qxu, Qxu, Sm, Sm, Sm, Sm, Sm, Rb, Rb, Sm, Sm, Rb, Sm, Sm, Sm, Sm, Sm, Xu, Xu, Xu, Uh, Rp, Xu, Xu, Xu, Xu, Xu, Xu, Xu
Xuc, Xuc, Qxu, Qxu, Qxu, Gll^Fdw, Gll^Fmw, Hhd^Fdw, Gll^Fdw, Gll^Fmw, Hhd^Fmw, Hhd, Rp, Rp, Rp, Rp, Qxu, Uu, Qxu, Xos, Xos, Qxu, Qxu, Qxu, Uu^Uf, Rb, Rb, Sm, Sm, Sm, Sm, Sm, Rb, Sm, Sm, Sm, Sm, Rb, Rb, Xu, Xu, Xu, Xu, Uu, Uu, Xu, Xu, Xu, Xu, Xu, Xu, Xu
Xuc, Xuc, Qxu, Qxu, Qxu, Gll^Fmw, Cud^Ii, Gll^Fmw, Hhd, Gll^Fmw, Rp, Rp, Rp, Rp, Hhd, Qxu, Qxu, Qxu, Qxu, Xos, Xu, Xos, Qxu, Qxu, Uu, Uu, Uu, Sm, Rb, Sm, Sm, Sm, Sm, Rb, Sm, Sm, Ur, Ur, Rb, Xu, Xu, Xu, Cud, Rb, Uu, Xu, Xu, Xu, Xu, Xu, Xu, Xu
Xuc, Xuc, Qxu, Qxu, Ur, Ur, Gll^Fmw, Ur, Ur, Hhd, Hhd, Rp, Gll^Fmw, Hhd, Gll^Fmw, Gll^Fdw, Qxu, Qxu, Gll^Fdw, Xos, Xu, Xos, Qxu, Qxu, Qxu, Uu^Ufi, Uu^Uf, Sm, Sm, Sm, Rb, Sm, Sm, Sm, Sm, Sm, Ur, Uu^Uf, Uu^Uf, Rb, Uh, Xu, Rb, Rb, Uu^Uf, Cud, Xos, Xu, Xos, Xu, Xu, Xu
Xuc, Xuc, Qxu, Cud^Ii, Gll^Fmw, Gll^Fdw, Gll^Fmw, Gll^Fmw, Gll^Fmw, Cud^Ii, Hhd, Gll^Fmw, Gll^Fmw, Gll^Fdw, Gll^Fmw, Gll^Fdw, Gll^Fdw, Gll^Fmw, Gll^Fmw, Xu, Xu, Xos, Xos, Qxu, Qxu, Qxu, Uh, Rb, Sm, Sm, Rb, Rb, Sm, Sm, Uu, Uu, Xu, Xu, Xu, Uu, Gll^Fdw, Gll^Fdw, Gll^Fdw, Gll^Fdw, Gll^Fdw, Uu, Gll^Fmw, Xos, Qxu, Xos, Xu, Xu
Xuc, Xuc, Xos, Ur, Gll^Fdw, Gll^Fdw, 2 Gll^Ii, Gll^Fdw, Gll^Fdw, Ur, Gll^Fdw, Gll^Fdw, Gll^Fmw, Gll^Fdw, Hhd^Fdw, Hhd^Fmw, Gll^Fdw, Gll^Fdw, Gll^Fdw, Gll^Fmw, Xu, Xu, Xos, Qxu, Qxu, Qxu, Qxu, Uh, Qxu, Sm, Qxu, Sm, Sm, Sm, Uh, Xu, Xos, Xos, Gll^Fdw, Gll^Fdw, Gll^Fmw, Gll^Fdw, Gll^Fmw, Gll^Fmw, Gll^Fmw, Gll^Fdw, Gll^Fmw, Gll^Fmw, Gll^Fmw, Qxu, Xu, Xu
Xuc, Xuc, Xos, Ur, Gll^Fmw, Gll^Fmw, Gll^Fdw, Gll^Fmw, Gll^Fdw, Ur, Gll^Fdw, Hhd^Fmw, Hhd^Fmw, Hhd^Fdw, Gll^Fmw, Hhd^Fdw, Gll^Fmw, Gll^Fmw, Gd^Fetd, Gll^Fmw, Xu, Xu, Xu, Qxu, Qxu, Qxu, Qxu, Qxu, Qxu, Qxu, Qxu, Qxu, Xu, Uh, Xu, Xu, Xos, Gll^Fmw, Gll^Fdw, Gll^Fdw, Gd^Fetd, Gll^Fmw, Gll^Fmw, Gll^Fmw, Gll^Fdw, Gll^Fmw, Gll^Fdw, Gll^Fmw, Gll^Fmw, Qxu, Xos, Xu
Xu, Xuc, Xos, Cud^Ii, Ur, Gll^Fdw, Gll^Fmw, Gll^Fmw, Ur, Cud^Ii, Qxu, Gll^Fdw, Qxu, Gll^Fdw, Qxu, Hhd^Fmw, Gll^Fdw, Gll^Fmw, Gll^Fmw, Gll^Fdw, Xu, Xu, Xu, Qxu, Qxu, Qxu, Xos, Qxu, Xos, Xos, Xos, Xos, Xu, Xu, Xu, Xu, Qxu, Gll^Fmw, Gll^Fmw, Gll^Fmw, Gll^Fdw, Gll^Fdw, Gll^Fmw, Gll^Fmw, Gll^Fdw, Gll^Fdw, Gd^Fetd, Gll^Fmw, Qxu, Qxu, Xos, Xu
Xu, Xu, Xos, Qxu, Qxu, Ur, Cud^Ii, Ur, Qxu, Qxu, Qxu, Qxu, Qxu, Qxu, Qxu, Qxu, Xos, Xos, Xos, Xos, Xu, Xu, Xu, Xu, Xu, Xos, Xu, Xos, Xu, Xu, Xu, Xu, Xu, Xu, Xu, Xos, Qxu, Qxu, Gll^Fdw, Gll^Fdw, Gll^Fdw, Gll^Fdw, Gll^Fdw, Gll^Fmw, Gll^Fdw, Gll^Fmw, Gll^Fmw, Gll^Fmw, Qxu, Qxu, Xos, Xu
Xu, Xu, Xu, Xos, Xos, Xos, Xos, Qxu, Xos, Xos, Xos, Qxu, Qxu, Qxu, Qxu, Qxu, Xu, Xu, Xu, Xu, Xu, Xu, Xu, Xu, Xu, Xu, Xu, Xu, Xu, Xu, Xu, Xu, Xu, Xu, Xu, Xos, Xos, Qxu, Gll^Fmw, Gll^Fmw, Gll^Fdw, Gll^Fmw, Gll^Fmw, Gll^Fmw, Gll^Fmw, Gll^Fdw, Gll^Fdw, Gll^Fdw, Qxu, Xos, Xu, Xu
Xu, Xu, Xu, Xu, Xu, Xu, Xu, Xos, Xu, Xu, Xu, Xos, Xos, Xos, Xu, Xu, Xu, Xu, Xu, Xu, Xu, Xu, Xu, Xu, Xu, Xu, Xu, Xu, Xu, Xu, Xu, Xu, Xu, Xu, Xu, Xu, Xu, Gll^Fmw, Gll^Fmw, Gll^Fdw, Qxu, Gll^Fdw, Xos, Gll^Fmw, Xos, Xos, Xos, Qxu, Qxu, Qxu, Xu, Xu
Xu, Xu, Xu, Xu, Xu, Xu, Xu, Xu, Xu, Xu, Xu, Xu, Xu, Xu, Xu, Xu, Xu, Xu, Xu, Xu, Xu, Xu, Xu, Xu, Xu, Xu, Xu, Xu, Xu, Xu, Xu, Xu, Xu, Xu, Xu, Xu, Xu, Xu, Xu, Qxu, Xu, Xos, Xu, Xos, Xu, Xu, Xu, Xos, Xu, Xu, Xu, Xu
Xu, Xu, Xu, Xu, Xu, Xu, Xu, Xu, Xu, Xu, Xu, Xu, Xu, Xu, Xu, Xu, Xu, Xu, Xu, Xu, Xu, Xu, Xu, Xu, Xu, Xu, Xu, Xu, Xu, Xu, Xu, Xu, Xu, Xu, Xu, Xu, Xu, Xu, Xu, Xu, Xu, Xu, Xu, Xu, Xu, Xu, Xu, Xu, Xu, Xu, Xu, Xu
